Alanis_Morissette	/award/award_nominee/award_nominations./award/award_nomination/award	Grammy_Award_for_Best_Female_Pop_Vocal_Performance
Happy_Feet	/film/film/genre	computer_animation
James_Stewart	/film/actor/film./film/performance/film	The_Philadelphia_Story
C.D._Nacional	/sports/sports_team/colors	white
X2	/film/film/country	Canada
Charles_Dance	/award/award_winner/awards_won./award/award_honor/award_winner	Kristin_Scott_Thomas
99th_United_States_Congress	/government/legislative_session/members./government/government_position_held/legislative_sessions	89th_United_States_Congress
Devin_Townsend	/people/person/nationality	Canada
Alanis_Morissette	/people/person/nationality	Canada
Jewish_people	/people/ethnicity/people	Gina_Gershon
Ferris_Bueller's_Day_Off	/film/film/featured_film_locations	Chicago
Grammy_Award_for_Best_Latin_Pop_Album	/award/award_category/winners./award/award_honor/ceremony	52nd_Annual_Grammy_Awards
Paramount_Pictures	/award/award_nominee/award_nominations./award/award_nomination/award	Academy_Award_for_Best_Animated_Short_Film
Josh_Groban	/base/popstra/celebrity/friendship./base/popstra/friendship/participant	Katy_Perry
20th_Century_Fox	/film/film_distributor/films_distributed./film/film_film_distributor_relationship/film	Ali
running_back	/sports/sports_position/players./sports/sports_team_roster/team	Baltimore_Ravens
Thoroughly_Modern_Millie	/film/film/language	Spanish
Chandra_Wilson	/award/award_winner/awards_won./award/award_honor/award_winner	James_Pickens
Academy_Award_for_Best_Picture	/award/award_category/nominees./award/award_nomination/nominated_for	The_Wizard_of_Oz
biathlon	/olympics/olympic_sport/athletes./olympics/olympic_athlete_affiliation/country	Switzerland
Bollywood	/media_common/netflix_genre/titles	Rang_De_Basanti
Nicole_Richie	/base/popstra/celebrity/dated./base/popstra/dated/participant	Tobey_Maguire
French	/language/human_language/countries_spoken_in	Tunisia
Independent_Spirit_Award_for_Best_Director	/award/award_category/nominees./award/award_nomination/nominated_for	Sideways
Reese_Witherspoon	/people/person/places_lived./people/place_lived/location	Louisiana
Easy_Rider	/film/film/written_by	Peter_Fonda
Red_State	/film/film/genre	action_film
Dan_Grimaldi	/award/award_nominee/award_nominations./award/award_nomination/award_nominee	Steve_Schirripa
pneumonia	/people/cause_of_death/people	Groucho_Marx
Game_of_Thrones	/award/award_winning_work/awards_won./award/award_honor/award	Primetime_Emmy_Award_for_Outstanding_Main_Title_Design
Charles_Dance	/award/award_nominee/award_nominations./award/award_nomination/nominated_for	Bleak_House
John_Quincy_Adams	/government/politician/government_positions_held./government/government_position_held/basic_title	president
president	/business/job_title/people_with_this_title./business/employment_tenure/company	Corpus_Christi_College
Katy_Perry	/award/award_nominee/award_nominations./award/award_nomination/award_nominee	Shakira
Sony_Pictures_Home_Entertainment	/film/film_distributor/films_distributed./film/film_film_distributor_relationship/film	The_Da_Vinci_Code
Alison_Krauss	/music/artist/track_contributions./music/track_contribution/role	viola
59th_Primetime_Emmy_Awards	/award/award_ceremony/awards_presented./award/award_honor/honored_for	Ugly_Betty
Meg_Ryan	/film/actor/film./film/performance/film	Anastasia
Annette_Bening	/award/award_nominee/award_nominations./award/award_nomination/award_nominee	Chris_Cooper
Southern_University	/education/educational_institution/students_graduates./education/education/student	David_Banner
Jerry_Bruckheimer	/people/person/places_lived./people/place_lived/location	New_York_City
Heavy_Metal	/film/film/featured_film_locations	New_York_City
Gary_Rydstrom	/people/person/place_of_birth	Chicago
running_back	/sports/sports_position/players./sports/sports_team_roster/team	Ole_Miss_Rebels_football
Ralph_Stanley	/award/award_nominee/award_nominations./award/award_nomination/award_nominee	Norman_Blake
Kevin_James	/base/popstra/celebrity/friendship./base/popstra/friendship/participant	Adam_Sandler
film	/education/field_of_study/students_majoring./education/education/student	Robbie_Coltrane
John_Romita,_Jr.	/people/person/place_of_birth	New_York_City
Jenna_Ushkowitz	/award/award_winner/awards_won./award/award_honor/award_winner	Josh_Sussman
African_Americans	/people/ethnicity/people	Chris_Tucker
Larenz_Tate	/film/actor/film./film/performance/film	Crash
Saul_Bellow	/people/person/nationality	Canada
Lausanne	/base/biblioness/bibs_location/country	Switzerland
Up	/film/film/language	Spanish
Ralph_Stanley	/award/award_winner/awards_won./award/award_honor/award_winner	Norman_Blake
64th_Primetime_Creative_Arts_Emmy_Awards	/award/award_ceremony/awards_presented./award/award_honor/honored_for	Game_of_Thrones
president	/business/job_title/people_with_this_title./business/employment_tenure/company	University_of_Georgia
Kingdom_of_the_Netherlands	/location/location/contains	Groningen
Josh_Sussman	/award/award_winner/awards_won./award/award_honor/award_winner	Patrick_Gallagher
Godzilla	/film/film/featured_film_locations	New_York_City
Bridget_Fonda	/film/actor/film./film/performance/film	Easy_Rider
New_Year's_Eve	/film/film/release_date_s./film/film_regional_release_date/film_release_region	Finland
National_Society_of_Film_Critics_Award_for_Best_Film	/award/award_category/nominees./award/award_nomination/nominated_for	Naked_Lunch
The_Green_Mile	/film/film/genre	prison_film
Tulane_University_Law_School	/education/educational_institution/school_type	private_university
vice_president	/business/job_title/people_with_this_title./business/employment_tenure/company	JPMorgan_Chase
Jamie_Cullum	/music/artist/track_contributions./music/track_contribution/role	electric_piano
Broadcast_Film_Critics_Association_Awards_2009	/award/award_ceremony/awards_presented./award/award_honor/honored_for	The_Young_Victoria
Adam_Sandler	/base/popstra/celebrity/friendship./base/popstra/friendship/participant	Allen_Covert
City,_University_of_London	/education/educational_institution/school_type	public_university
Independent_Spirit_Award_for_Best_Director	/award/award_category/winners./award/award_honor/award_winner	Ang_Lee
Anthony_Mackie	/film/actor/film./film/performance/film	The_Manchurian_Candidate
Speed	/film/film/other_crew./film/film_crew_gig/film_crew_role	storyboard_artist
Joseph_Heller	/influence/influence_node/influenced_by	Franz_Kafka
contemporary_R&B	/music/genre/artists	D'Angelo
Kader_Khan	/people/person/profession	comedian
running_back	/sports/sports_position/players./sports/sports_team_roster/team	West_Virginia_Mountaineers_football
No_Wave	/music/genre/parent_genre	post-punk
Jackass_3D	/film/film/production_companies	Paramount_Pictures
Timothy_Busfield	/people/person/places_lived./people/place_lived/location	Sacramento
Victor_Victoria	/award/award_winning_work/awards_won./award/award_honor/award_winner	Leslie_Bricusse
Fred_Quimby	/people/person/profession	journalist
James_Pickens	/award/award_winner/awards_won./award/award_honor/award_winner	Chandra_Wilson
Portugal_national_football_team	/base/x2010fifaworldcupsouthafrica/world_cup_squad/current_world_cup_squad./base/x2010fifaworldcupsouthafrica/current_world_cup_squad/current_club	VfL_Wolfsburg
Liam_Neeson	/film/actor/film./film/performance/film	Clash_of_the_Titans
Charles_Pratt	/award/award_winner/awards_won./award/award_honor/award_winner	Robert_Guza,_Jr.
106th_United_States_Congress	/government/legislative_session/members./government/government_position_held/legislative_sessions	103rd_United_States_Congress
Michael_Tollin	/tv/tv_producer/programs_produced./tv/tv_producer_term/program	Smallville
Frances_Conroy	/award/award_nominee/award_nominations./award/award_nomination/award_nominee	Lili_Taylor
Sicko	/film/film/personal_appearances./film/personal_film_appearance/person	Michael_Moore
Leipzig	/base/biblioness/bibs_location/state	Saxony
Six_Feet_Under	/award/award_winning_work/awards_won./award/award_honor/award_winner	Lili_Taylor
BAFTA_Award_for_Best_Actor_in_a_Supporting_Role	/award/award_category/winners./award/award_honor/award_winner	Tim_Roth
Willow	/film/film/genre	action_film
Delroy_Facey	/sports/pro_athlete/teams./sports/sports_team_roster/team	Burnley_F.C.
Steve_Schirripa	/award/award_winner/awards_won./award/award_honor/award_winner	Jamie-Lynn_Sigler
L._Frank_Baum	/people/person/profession	journalist
Arista_Records	/music/record_label/artist	Simple_Minds
Final_Destination_5	/film/film/release_date_s./film/film_regional_release_date/film_release_region	Finland
Jon_Voight	/award/award_nominee/award_nominations./award/award_nomination/nominated_for	Coming_Home
Easy_Rider	/film/film/featured_film_locations	Tucson
Thunderball	/film/film/language	French
J._Michael_Straczynski	/people/person/places_lived./people/place_lived/location	Dallas
Om_Prakash	/award/award_nominee/award_nominations./award/award_nomination/award	Filmfare_Award_for_Best_Supporting_Actor
alto_saxophone	/music/performance_role/regular_performances./music/group_membership/group	Oingo_Boingo
1997_Grammy_Awards	/award/award_ceremony/awards_presented./award/award_honor/award_winner	Al_Franken
DeWitt_Clinton_High_School	/education/educational_institution/students_graduates./education/education/student	James_Baldwin
Alison_Krauss	/award/award_winner/awards_won./award/award_honor/award_winner	Chris_Thile
Philadelphia	/film/film/costume_design_by	Colleen_Atwood
2007_NBA_Draft	/sports/sports_league_draft/picks./sports/sports_league_draft_pick/school	Rice_University
Homeland	/tv/tv_program/regular_cast./tv/regular_tv_appearance/actor	Damian_Lewis
Canada	/olympics/olympic_participating_country/medals_won./olympics/olympic_medal_honor/olympics	1968_Winter_Olympics
broccoli	/food/food/nutrients./food/nutrition_fact/nutrient	protein
Dean_Devlin	/award/award_nominee/award_nominations./award/award_nomination/award_nominee	20th_Century_Fox
Imagine_Entertainment	/business/business_operation/industry	film
Primetime_Emmy_Award_for_Outstanding_Writing_for_a_Miniseries,_Movie_or_a_Dramatic_Special	/award/award_category/winners./award/award_honor/award_winner	Tony_Kushner
Craig_Bellamy	/people/person/place_of_birth	Cardiff
Life_Insurance_Corporation_of_India	/base/schemastaging/organization_extra/phone_number./base/schemastaging/phone_sandbox/service_location	Varanasi
funk	/music/genre/artists	Jamiroquai
vice_president	/business/job_title/people_with_this_title./business/employment_tenure/company	The_McClatchy_Company
Sony_BMG	/music/record_label/artist	Trey_Anastasio
biography	/media_common/netflix_genre/titles	Downfall
Salem	/location/location/contains	Willamette_University
Ellen_Pompeo	/award/award_winner/awards_won./award/award_honor/award_winner	James_Pickens
John_Frink	/award/award_nominee/award_nominations./award/award_nomination/award_nominee	Matt_Selman
Dean_Devlin	/people/person/places_lived./people/place_lived/location	New_York_City
Oliver_Cromwell	/people/person/nationality	Kingdom_of_England
Jon_Voight	/film/actor/film./film/performance/film	Pearl_Harbor
The_O.C.	/tv/tv_program/genre	comedy-drama
Ron_Carter	/award/award_nominee/award_nominations./award/award_nomination/award	Grammy_Award_for_Best_Jazz_Instrumental_Album
Angela_Kinsey	/award/award_nominee/award_nominations./award/award_nomination/award_nominee	Craig_Robinson
University_of_Arkansas	/education/educational_institution/school_type	university
Jewish_people	/people/ethnicity/people	Philip_Glass
Sanjay_Dutt	/people/person/spouse_s./people/marriage/location_of_ceremony	Goa
52nd_Annual_Grammy_Awards	/award/award_ceremony/awards_presented./award/award_honor/award_winner	Randy_Travis
teen_drama	/media_common/netflix_genre/titles	The_O.C.
William_Petersen	/people/person/place_of_birth	Evanston
Ethan_Hawke	/film/actor/film./film/performance/film	Training_Day
Filmfare_Award_for_Best_Supporting_Actor	/award/award_category/winners./award/award_honor/award_winner	Amrish_Puri
Butch_Cassidy_and_the_Sundance_Kid	/film/film/film_format	35_mm_film
mayor	/government/government_office_category/officeholders./government/government_position_held/jurisdiction_of_office	Brampton
Magical_Girl_Lyrical_Nanoha	/tv/tv_program/genre	action_film
Clark_Gregg	/film/actor/film./film/performance/film	The_Human_Stain
Boeing	/business/business_operation/industry	arms_industry
It's_a_Mad,_Mad,_Mad,_Mad_World	/film/film/genre	action_film
African_Americans	/people/ethnicity/people	Charles_Mingus_Jr.
Al_Franken	/people/person/places_lived./people/place_lived/location	New_York_City
Nokia	/base/schemastaging/organization_extra/phone_number./base/schemastaging/phone_sandbox/service_language	French
Adaptation	/award/award_winning_work/awards_won./award/award_honor/award_winner	Chris_Cooper
Tucker:_The_Man_and_His_Dream	/film/film/production_companies	Paramount_Pictures
progressive_metal	/music/genre/artists	Buckethead
Paul_Auster	/influence/influence_node/influenced_by	William_Faulkner
Kingdom_of_England	/military/military_combatant/military_conflicts./military/military_combatant_group/combatants	Swedish_Empire
Peter_Sellers	/base/popstra/celebrity/friendship./base/popstra/friendship/participant	The_Beatles
64th_Primetime_Creative_Arts_Emmy_Awards	/award/award_ceremony/awards_presented./award/award_honor/honored_for	Two_and_a_Half_Men
Jewish_people	/people/ethnicity/people	Billy_Wilder
washboard	/music/performance_role/regular_performances./music/group_membership/role	viola
The_Artist	/film/film/release_date_s./film/film_regional_release_date/film_release_region	Canada
Very_Bad_Things	/film/film/release_date_s./film/film_regional_release_date/film_release_region	Switzerland
Magical_Girl_Lyrical_Nanoha	/tv/tv_program/regular_cast./tv/regular_tv_appearance/actor	Nana_Mizuki
Leslie_Bricusse	/award/award_nominee/award_nominations./award/award_nomination/nominated_for	Victor_Victoria
mayor	/government/government_office_category/officeholders./government/government_position_held/jurisdiction_of_office	Tucson
Chiwetel_Ejiofor	/award/award_nominee/award_nominations./award/award_nomination/award_nominee	Liam_Neeson
The_Island_Def_Jam_Music_Group	/music/record_label/artist	The_Isley_Brothers
Latin_Grammy_Award_for_Album_of_the_Year	/award/award_category/winners./award/award_honor/ceremony	Latin_Grammy_Awards_of_2005
mayor	/government/government_office_category/officeholders./government/government_position_held/jurisdiction_of_office	Colorado_Springs
Bethel_Census_Area	/base/aareas/schema/administrative_area/administrative_parent	Alaska
Craig_Carlson	/award/award_winner/awards_won./award/award_honor/award_winner	N._Gail_Lawrence
Kirsten_Dunst	/award/award_winner/awards_won./award/award_honor/award_winner	Tobey_Maguire
Robert_Forster	/award/award_nominee/award_nominations./award/award_nomination/nominated_for	Jackie_Brown
vice_president	/business/job_title/people_with_this_title./business/employment_tenure/company	Citadel_Broadcasting
Switzerland	/location/location/contains	Lausanne
Helen_Mirren	/people/person/languages	French
double_bass	/music/performance_role/track_performances./music/track_contribution/role	vibraphone
Jamie-Lynn_Sigler	/award/award_nominee/award_nominations./award/award_nomination/award_nominee	Steve_Schirripa
Katharine_Hepburn	/film/actor/film./film/performance/film	The_Philadelphia_Story
1968_Winter_Olympics	/olympics/olympic_games/sports	biathlon
Alberto_Iglesias	/award/award_nominee/award_nominations./award/award_nomination/nominated_for	The_Kite_Runner
52nd_Annual_Grammy_Awards	/award/award_ceremony/awards_presented./award/award_honor/award_winner	Steve_Earle
59th_Primetime_Emmy_Awards	/award/award_ceremony/awards_presented./award/award_honor/award_winner	Sheila_Nevins
president	/business/job_title/people_with_this_title./business/employment_tenure/company	Johns_Hopkins_University
Allen_Ginsberg	/award/award_nominee/award_nominations./award/award_nomination/award	National_Book_Award_for_Poetry
Tel_Aviv_University	/education/educational_institution/school_type	public_university
Motherland	/film/film/genre	biography
Alison_Krauss	/award/award_nominee/award_nominations./award/award_nomination/award_nominee	Chris_Botti
Friesland	/location/location/adjoin_s./location/adjoining_relationship/adjoins	Groningen
Michael_Moore	/film/director/film	Sicko
JPMorgan_Chase	/base/schemastaging/organization_extra/phone_number./base/schemastaging/phone_sandbox/service_location	Canada
Europe	/location/location/partially_contains	Kingdom_of_the_Netherlands
Alison_Krauss	/award/award_nominee/award_nominations./award/award_nomination/award_nominee	Dwight_Yoakam
Neal_McDonough	/people/person/place_of_birth	Dorchester
EMI_Records	/music/record_label/artist	Olivia_Newton-John
Pearl_Harbor	/film/film/production_companies	Touchstone_Pictures
The_Artist	/award/award_winning_work/awards_won./award/award_honor/award	Cannes_Film_Festival_Award_for_Best_Actor
Washington,_D.C.	/location/statistical_region/religions./location/religion_percentage/religion	Seventh-day_Adventist_Church
James_L._Brooks	/award/award_nominee/award_nominations./award/award_nomination/award	Academy_Award_for_Best_Picture
Nokia	/base/schemastaging/organization_extra/phone_number./base/schemastaging/phone_sandbox/service_location	Canada
Peter_Fonda	/film/actor/film./film/performance/film	Easy_Rider
BAFTA_Award_for_Best_Actor_in_a_Supporting_Role	/award/award_category/nominees./award/award_nomination/nominated_for	The_Crucible
Steven_Bochco	/award/award_nominee/award_nominations./award/award_nomination/nominated_for	L.A._Law
Colleen_Atwood	/people/person/place_of_birth	Yakima
Mark_Gordon	/film/actor/film./film/performance/film	Speed
Joshua_Redman	/award/award_winner/awards_won./award/award_honor/award_winner	Chris_Thile
Training_Day	/award/award_winning_work/awards_won./award/award_honor/award_winner	Mark_Mancina
J._Michael_Straczynski	/people/person/places_lived./people/place_lived/location	Kankakee
BAFTA_Academy_Fellowship_Award	/award/award_category/winners./award/award_honor/award_winner	Louis_Malle
Bowling_for_Columbine	/film/film/written_by	Michael_Moore
Southern_University	/organization/organization/headquarters./location/mailing_address/state_province_region	Louisiana
judo	/olympics/olympic_sport/athletes./olympics/olympic_athlete_affiliation/country	Benin
Remember_the_Titans	/film/film/release_date_s./film/film_regional_release_date/film_release_region	Finland
Dallas	/sports/sports_team_location/teams	F.C._Dallas
Patrick_Gallagher	/film/actor/film./film/performance/film	Sideways
Gramercy_Pictures	/film/film_distributor/films_distributed./film/film_film_distributor_relationship/film	Four_Weddings_and_a_Funeral
Casper	/film/film/cinematography	Dean_Cundey
Nirvana	/award/award_nominee/award_nominations./award/award_nomination/award	MTV_Video_Music_Award_for_Best_Cinematography
Allen_Covert	/people/person/profession	comedian
Memento	/award/award_winning_work/awards_won./award/award_honor/award	MTV_Movie_Award_for_Best_New_Filmmaker
20th_Century_Fox	/award/award_nominee/award_nominations./award/award_nomination/award	Academy_Award_for_Best_Animated_Short_Film
Academy_Award_for_Best_Picture	/award/award_category/nominees./award/award_nomination/nominated_for	Heaven_Can_Wait
Patrick_Gallagher	/award/award_nominee/award_nominations./award/award_nomination/award_nominee	Amber_Riley
mayor	/government/government_office_category/officeholders./government/government_position_held/jurisdiction_of_office	St._Petersburg
Colleen_Dewhurst	/award/award_nominee/award_nominations./award/award_nomination/award	Tony_Award_for_Best_Actress_in_a_Play
prime_minister	/government/government_office_category/officeholders./government/government_position_held/jurisdiction_of_office	Canada
Chris_Cooper	/award/award_winner/awards_won./award/award_honor/award_winner	Annette_Bening
Kingdom_of_the_Netherlands	/location/location/contains	Dordrecht
Academy_Award_for_Best_Animated_Short_Film	/award/award_category/winners./award/award_honor/ceremony	21st_Academy_Awards
Kirk_Douglas	/people/person/languages	French
William_Friedkin	/film/director/film	The_French_Connection
Helen_Mirren	/award/award_nominee/award_nominations./award/award_nomination/nominated_for	Calendar_Girls
Sacramento	/location/location/contains	California_State_University,_Sacramento
president	/government/government_office_category/officeholders./government/government_position_held/jurisdiction_of_office	Uganda
The_Lorax	/film/film/genre	computer_animation
biography	/media_common/netflix_genre/titles	The_Young_Victoria
Sofia_Coppola	/award/award_nominee/award_nominations./award/award_nomination/award	Golden_Raspberry_Award_for_Worst_New_Star
Crash	/award/award_winning_work/awards_won./award/award_honor/award	Academy_Award_for_Best_Picture
Patricia_Heaton	/people/person/places_lived./people/place_lived/location	Buckinghamshire
Peter_Riegert	/award/award_winner/awards_won./award/award_honor/award_winner	Benicio_del_Toro
lung_cancer	/people/cause_of_death/people	James_Wong
Jenna_Ushkowitz	/award/award_winner/awards_won./award/award_honor/award_winner	Amber_Riley
Roberto_Orci	/people/person/places_lived./people/place_lived/location	Canada
Shakira	/award/award_nominee/award_nominations./award/award_nomination/award	Latin_Grammy_Award_for_Album_of_the_Year
L.A._Law	/tv/tv_program/program_creator	Steven_Bochco
Shirley_Henderson	/award/award_nominee/award_nominations./award/award_nomination/award_nominee	Paul_Reubens
Bodyguards_and_Assassins	/film/film/genre	action_film
Robert_Zemeckis	/film/director/film	Forrest_Gump
Djimon_Hounsou	/people/person/nationality	Benin
Ferris_Bueller's_Day_Off	/film/film/release_date_s./film/film_regional_release_date/film_release_region	Canada
Curtis_Armstrong	/film/actor/film./film/performance/film	Smokin'_Aces
Rushmore	/film/film/language	French
Columbia	/location/hud_county_place/county	Howard_County
Rang_De_Basanti	/film/film/genre	Bollywood
Swedish_Empire	/military/military_combatant/military_conflicts./military/military_combatant_group/combatants	Kingdom_of_England
Academy_Award_for_Best_Picture	/award/award_category/winners./award/award_honor/ceremony	82nd_Academy_Awards
Joshua_Redman	/award/award_nominee/award_nominations./award/award_nomination/award_nominee	Alison_Krauss
Meg_Ryan	/film/actor/film./film/performance/film	Searching_for_Debra_Winger
Darryl_Hannah	/people/person/place_of_birth	Chicago
Cannes_Film_Festival_Award_for_Best_Actor	/award/award_category/disciplines_or_subjects	film
Jackass_Number_Two	/film/film/genre	slapstick
Vassar_College	/education/educational_institution/colors	grey
Academy_Award_for_Best_Animated_Short_Film	/award/award_category/winners./award/award_honor/ceremony	82nd_Academy_Awards
Peter_Fonda	/people/person/place_of_birth	New_York_City
Crash	/film/film/produced_by	Bob_Yari
Michael_Moore	/people/person/places_lived./people/place_lived/location	New_York_City
Sicko	/film/film/language	Spanish
BAFTA_Award_for_Best_Actor_in_a_Supporting_Role	/award/award_category/winners./award/award_honor/award_winner	Robert_Duvall
Peter_Jackson	/award/award_nominee/award_nominations./award/award_nomination/award_nominee	Kathleen_Kennedy
Grammy_Award_for_Best_Traditional_Blues_Album	/award/award_category/winners./award/award_honor/ceremony	52nd_Annual_Grammy_Awards
Primetime_Emmy_Award_for_Outstanding_Writing_for_a_Miniseries,_Movie_or_a_Dramatic_Special	/award/award_category/category_of	Primetime_Emmy_Award
running_back	/sports/sports_position/players./sports/sports_team_roster/team	Green_Bay_Packers
defenceman	/sports/sports_position/players./sports/sports_team_roster/team	Providence_Bruins
Patricia_Heaton	/award/award_winner/awards_won./award/award_honor/award_winner	Doris_Roberts
2001:_A_Space_Odyssey	/award/award_winning_work/awards_won./award/award_honor/award_winner	Geoffrey_Unsworth
Grammy_Award_for_Best_Female_Pop_Vocal_Performance	/award/award_category/winners./award/award_honor/award_winner	Olivia_Newton-John
52nd_Annual_Grammy_Awards	/award/award_ceremony/awards_presented./award/award_honor/award_winner	Alison_Krauss
president	/business/job_title/people_with_this_title./business/employment_tenure/company	Ford
Lou_Reed	/people/person/profession	singer-songwriter
Fluminense_F.C.	/sports/sports_team/colors	white
Joshua_Redman	/award/award_winner/awards_won./award/award_honor/award_winner	Chris_Botti
PepsiCo	/organization/organization/place_founded	Chicago
Victor_Victoria	/film/film/genre	sex_comedy
Independent_Spirit_Award_for_Best_Director	/award/award_category/winners./award/award_honor/award_winner	John_Huston
82nd_Academy_Awards	/award/award_ceremony/awards_presented./award/award_honor/honored_for	Up
mayor	/government/government_office_category/officeholders./government/government_position_held/jurisdiction_of_office	Tulsa
Hebrew_University_of_Jerusalem	/education/educational_institution/school_type	public_university
Louisiana	/location/statistical_region/religions./location/religion_percentage/religion	Seventh-day_Adventist_Church
Canada	/location/country/official_language	French
Fred_Willard	/film/actor/film./film/performance/film	This_Is_Spinal_Tap
Yo-Yo_Ma	/award/award_winner/awards_won./award/award_honor/award_winner	Chris_Thile
judo	/olympics/olympic_sport/athletes./olympics/olympic_athlete_affiliation/country	Tunisia
broccoli	/food/food/nutrients./food/nutrition_fact/nutrient	vitamin_B6
Very_Bad_Things	/film/film/release_date_s./film/film_regional_release_date/film_release_region	Finland
Yo-Yo_Ma	/award/award_winner/awards_won./award/award_honor/award_winner	Joshua_Redman
Athletic_Club	/sports/sports_team/colors	white
contemporary_R&B	/music/genre/artists	James_Poyser
Jewish_people	/people/ethnicity/people	Irving_Thalberg
64th_Primetime_Creative_Arts_Emmy_Awards	/award/award_ceremony/awards_presented./award/award_honor/honored_for	Homeland
Chiwetel_Ejiofor	/award/award_nominee/award_nominations./award/award_nomination/nominated_for	Love_Actually
slapstick	/media_common/netflix_genre/titles	Norbit
Senna	/film/film/genre	biography
Joseph_Heller	/influence/influence_node/influenced_by	Thomas_Mann
pop_punk	/music/genre/artists	Kelly_Osbourne
double_bass	/music/instrument/family	string_instrument
Regina	/base/biblioness/bibs_location/country	Canada
Groucho_Marx	/people/person/profession	comedian
Bridget_Fonda	/film/actor/film./film/performance/film	Jackie_Brown
pneumonia	/people/cause_of_death/people	Red_Skelton
Anne_McCaffrey	/people/person/places_lived./people/place_lived/location	Cambridge
Sofia_Coppola	/film/actor/film./film/performance/film	The_Cotton_Club
Dan_Aykroyd	/film/actor/film./film/performance/film	Pearl_Harbor
Canada	/military/military_combatant/military_conflicts./military/military_combatant_group/combatants	Union_of_South_Africa
Richard_Nixon	/government/politician/government_positions_held./government/government_position_held/basic_title	president
mayor	/government/government_office_category/officeholders./government/government_position_held/jurisdiction_of_office	Chico
prime_minister	/government/government_office_category/officeholders./government/government_position_held/jurisdiction_of_office	Guinea
National_Society_of_Film_Critics_Award_for_Best_Film	/award/award_category/nominees./award/award_nomination/nominated_for	The_Lord_of_the_Rings:_The_Fellowship_of_the_Ring
Nana_Mizuki	/film/actor/film./film/performance/film	Naruto_Shippuden_the_Movie:_Bonds
Evanston	/location/location/adjoin_s./location/adjoining_relationship/adjoins	Chicago
Hugh_Hefner	/people/person/place_of_birth	Chicago
Scott_Pilgrim_vs._the_World	/film/film/other_crew./film/film_crew_gig/film_crew_role	storyboard_artist
The_Postman	/film/film/story_by	David_Brin
/m/02kxbwx	/award/award_nominee/award_nominations./award/award_nomination/award	Academy_Award_for_Best_Picture
On_Her_Majesty's_Secret_Service	/film/film/written_by	Ian_Fleming
Dumb_and_Dumber	/film/film/release_date_s./film/film_regional_release_date/film_release_region	Finland
pop_punk	/music/genre/artists	Travis_Barker
The_Fisher_King	/film/film/featured_film_locations	New_York_City
president	/government/government_office_category/officeholders./government/government_position_held/jurisdiction_of_office	Guinea
Screen_Actors_Guild_Award_for_Outstanding_Performance_by_a_Female_Actor_in_a_Drama_Series	/award/award_category/winners./award/award_honor/award_winner	Chandra_Wilson
Chicken_Little	/film/film/genre	computer_animation
Avicenna	/people/person/profession	mathematician
Katy_Perry	/award/award_nominee/award_nominations./award/award_nomination/award	Grammy_Award_for_Best_Female_Pop_Vocal_Performance
Michael_Moore	/award/award_nominee/award_nominations./award/award_nomination/nominated_for	Bowling_for_Columbine
The_Fast_and_the_Furious	/film/film/music	BT
African_Americans	/people/ethnicity/people	Busta_Rhymes
Doctor_of_Medicine	/education/educational_degree/people_with_this_degree./education/education/institution	University_of_California,_Los_Angeles
Screen_Actors_Guild_Award_for_Outstanding_Performance_by_a_Female_Actor_in_a_Drama_Series	/award/award_category/winners./award/award_honor/award_winner	Frances_Conroy
59th_Primetime_Emmy_Awards	/time/event/instance_of_recurring_event	Primetime_Emmy_Award
Glenn_Frey	/music/group_member/membership./music/group_membership/group	Eagles
Solanum_lycopersicum	/food/food/nutrients./food/nutrition_fact/nutrient	vitamin_B6
French	/education/field_of_study/students_majoring./education/education/student	J._K._Rowling
BAFTA_Award_for_Best_Actor_in_a_Supporting_Role	/award/award_category/nominees./award/award_nomination/nominated_for	The_Deer_Hunter
Gladys_Knight	/people/person/profession	singer-songwriter
Rod_Serling	/people/person/places_lived./people/place_lived/location	Binghamton
Paramount_Pictures	/film/film_distributor/films_distributed./film/film_film_distributor_relationship/film	The_Manchurian_Candidate
Angela_Kinsey	/award/award_winner/awards_won./award/award_honor/award_winner	Creed_Bratton
N._Gail_Lawrence	/award/award_winner/awards_won./award/award_honor/award_winner	Craig_Carlson
running_back	/sports/sports_position/players./sports/sports_team_roster/team	San_Diego_State_Aztecs_football
Canada	/location/location/adjoin_s./location/adjoining_relationship/adjoins	Wayne_County
Jerry_Orbach	/award/award_nominee/award_nominations./award/award_nomination/award_nominee	Sam_Waterston
pneumonia	/people/cause_of_death/people	Max_Weber
59th_Primetime_Emmy_Awards	/award/award_ceremony/awards_presented./award/award_honor/award_winner	Ricky_Gervais
The_Lord_of_the_Rings:_The_Fellowship_of_the_Ring	/film/film/release_date_s./film/film_regional_release_date/film_release_region	Finland
Brandeis_University	/education/educational_institution/students_graduates./education/education/student	Loretta_Devine
Alanis_Morissette	/award/award_nominee/award_nominations./award/award_nomination/nominated_for	City_of_Angels
funk	/music/genre/artists	D'Angelo
Shannon_Elizabeth	/award/award_nominee/award_nominations./award/award_nomination/award_nominee	Liam_Neeson
2007_NBA_Draft	/sports/sports_league_draft/picks./sports/sports_league_draft_pick/school	University_of_California,_Los_Angeles
Canada	/location/location/contains	Regina
The_Artist	/film/film/release_date_s./film/film_regional_release_date/film_release_region	Switzerland
Tobey_Maguire	/base/popstra/celebrity/breakup./base/popstra/breakup/participant	Nicole_Richie
Unstoppable	/film/film/genre	action_film
Guildhall_School_of_Music_and_Drama	/education/educational_institution/students_graduates./education/education/student	Damian_Lewis
post-bop	/music/genre/artists	Charles_Mingus_Jr.
Rory_Cochrane	/people/person/places_lived./people/place_lived/location	Syracuse
Godzilla	/film/film/written_by	Dean_Devlin
Adaptation	/film/film/film_format	35_mm_film
Shakira	/people/person/languages	Spanish
Helen_Mirren	/award/award_winner/awards_won./award/award_honor/award_winner	Charles_Dance
National_Society_of_Film_Critics_Award_for_Best_Actress	/award/award_category/winners./award/award_honor/award_winner	Helen_Mirren
Coldplay	/award/award_nominee/award_nominations./award/award_nomination/award_nominee	Lady_Gaga
Rickey_Henderson	/people/person/place_of_birth	Chicago
Robert_Duvall	/award/award_nominee/award_nominations./award/award_nomination/award	Independent_Spirit_Award_for_Best_Director
Eastern_Illinois_University	/education/educational_institution/colors	grey
Primetime_Emmy_Award_for_Outstanding_Main_Title_Design	/award/award_category/winners./award/award_honor/ceremony	64th_Primetime_Creative_Arts_Emmy_Awards
Rod_Serling	/people/person/place_of_birth	Syracuse
Aristotle	/people/person/profession	mathematician
The_Lorax	/film/film/release_date_s./film/film_regional_release_date/film_release_region	Canada
president	/business/job_title/people_with_this_title./business/employment_tenure/company	Brandeis_University
Grammy_Award_for_Best_Female_Pop_Vocal_Performance	/award/award_category/winners./award/award_honor/award_winner	Christina_Aguilera
Rushmore	/film/film/release_date_s./film/film_regional_release_date/film_release_region	New_York_City
102nd_United_States_Congress	/government/legislative_session/members./government/government_position_held/legislative_sessions	103rd_United_States_Congress
Jackass_3D	/film/film/personal_appearances./film/personal_film_appearance/person	Bam_Margera
Ja_Rule	/people/person/place_of_birth	New_York_City
Pembroke_College	/education/educational_institution/school_type	university
biathlon	/olympics/olympic_sport/athletes./olympics/olympic_athlete_affiliation/country	Finland
Grammy_Award_for_Best_Female_Pop_Vocal_Performance	/award/award_category/winners./award/award_honor/award_winner	Toni_Braxton
Paramount_Pictures	/film/film_distributor/films_distributed./film/film_film_distributor_relationship/film	Hot_Fuzz
Liam_Neeson	/award/award_nominee/award_nominations./award/award_nomination/award_nominee	Sienna_Guillory
Lisa_Gerrard	/award/award_nominee/award_nominations./award/award_nomination/nominated_for	Ali
Cabaret	/award/award_winning_work/awards_won./award/award_honor/award_winner	Geoffrey_Unsworth
French	/education/field_of_study/students_majoring./education/education/major_field_of_study	Spanish
Newcastle_upon_Tyne	/location/location/contains	Newcastle_University
alto_saxophone	/music/performance_role/track_performances./music/track_contribution/role	double_bass
Gus_Van_Sant	/film/director/film	Paris,_je_t'aime
electric_piano	/music/performance_role/regular_performances./music/group_membership/role	viola
Europe	/location/location/contains	Georgia
Dido	/award/award_nominee/award_nominations./award/award_nomination/award	Grammy_Award_for_Best_Female_Pop_Vocal_Performance
The_Golden_Compass	/film/film/release_date_s./film/film_regional_release_date/film_release_region	Finland
Bowling_for_Columbine	/film/film/produced_by	Michael_Moore
Norman_Blake	/people/person/profession	singer-songwriter
Gone_with_the_Wind	/film/film/film_production_design_by	William_Cameron_Menzies
Remember_the_Titans	/film/film/produced_by	Jerry_Bruckheimer
president	/government/government_office_category/officeholders./government/government_position_held/jurisdiction_of_office	Georgia
Robbie_Coltrane	/people/person/profession	comedian
Primetime_Emmy_Award_for_Outstanding_Main_Title_Design	/award/award_category/nominees./award/award_nomination/nominated_for	Ugly_Betty
Pearl_Harbor	/film/film/language	French
13_Assassins	/film/film/release_date_s./film/film_regional_release_date/film_release_region	Canada
Ali	/award/award_winning_work/awards_won./award/award_honor/award_winner	Jon_Voight
Jeffrey_Wright	/film/actor/film./film/performance/film	The_Manchurian_Candidate
African_Americans	/people/ethnicity/people	Kirk_Franklin
Darryl_Hannah	/film/actor/film./film/performance/film	Searching_for_Debra_Winger
Guildhall_School_of_Music_and_Drama	/education/educational_institution/students_graduates./education/education/student	Shirley_Henderson
Grown_Ups	/film/film/produced_by	Adam_Sandler
Martine_McCutcheon	/award/award_nominee/award_nominations./award/award_nomination/award_nominee	Liam_Neeson
20th_Century_Fox	/award/award_nominee/award_nominations./award/award_nomination/nominated_for	Heaven_Can_Wait
Dwight_Yoakam	/award/award_winner/awards_won./award/award_honor/award_winner	Randy_Travis
The_Postman	/award/award_nominated_work/award_nominations./award/award_nomination/nominated_for	Waterworld
John_Hurt	/award/award_nominee/award_nominations./award/award_nomination/nominated_for	The_Proposition
Tracey_Ullman	/people/person/profession	comedian
president	/government/government_office_category/officeholders./government/government_position_held/jurisdiction_of_office	Gabon
Chicago_White_Sox	/sports/professional_sports_team/draft_picks./sports/sports_league_draft_pick/school	Southern_University
Sideways	/award/award_winning_work/awards_won./award/award_honor/award	Independent_Spirit_Award_for_Best_Director
Yoram_Globus	/award/award_nominee/award_nominations./award/award_nomination/award_nominee	Franco_Zeffirelli
Kim_Kardashian	/base/popstra/celebrity/friendship./base/popstra/friendship/participant	Nicole_Richie
89th_United_States_Congress	/government/legislative_session/members./government/government_position_held/legislative_sessions	106th_United_States_Congress
Rushmore	/film/film/production_companies	Touchstone_Pictures
Television_Broadcasts_Limited	/business/business_operation/industry	broadcasting
French	/language/human_language/countries_spoken_in	Gabon
William_Petersen	/people/person/places_lived./people/place_lived/location	Evanston
Yale_Law_School	/education/educational_institution/school_type	private_university
Chandra_Wilson	/award/award_winner/awards_won./award/award_honor/award_winner	Kate_Walsh
Roy_Webb	/people/person/place_of_birth	New_York_City
Waterworld	/film/film/genre	action_film
Static_Major	/award/award_nominee/award_nominations./award/award_nomination/award_nominee	Busta_Rhymes
City_of_Angels	/award/award_winning_work/awards_won./award/award_honor/award_winner	Alanis_Morissette
Ghostbusters_II	/film/film/genre	action_film
Primetime_Emmy_Award_for_Outstanding_Main_Title_Theme_Music	/award/award_category/nominees./award/award_nomination/nominated_for	Homeland
Academy_Award_for_Best_Picture	/award/award_category/nominees./award/award_nomination/nominated_for	Ben-Hur
Godzilla	/film/film/produced_by	Dean_Devlin
The_Insider	/film/film/production_companies	Touchstone_Pictures
Broward_County	/location/location/contains	Pompano_Beach
Sony_BMG	/music/record_label/artist	Kelis
Guy_Pearce	/film/actor/film./film/performance/film	The_Adventures_of_Priscilla,_Queen_of_the_Desert
Mark_Gordon	/award/award_nominee/award_nominations./award/award_nomination/award	Academy_Award_for_Best_Picture
National_Society_of_Film_Critics_Award_for_Best_Film	/award/award_category/nominees./award/award_nomination/nominated_for	Lost_in_Translation
Europe	/location/location/contains	Kingdom_of_England
Aaron_Shure	/award/award_nominee/award_nominations./award/award_nomination/award_nominee	Ricky_Gervais
Cabaret	/film/film/language	French
Trey_Anastasio	/people/person/place_of_birth	Fort_Worth
Liam_Neeson	/film/actor/film./film/performance/film	The_Newton_Boys
1964_Summer_Olympics	/olympics/olympic_games/sports	road_cycling
Billy_Joel	/award/award_nominee/award_nominations./award/award_nomination/award	MTV_Video_Music_Award_for_Best_Cinematography
Russi_Taylor	/people/person/place_of_birth	Cambridge
mayor	/government/government_office_category/officeholders./government/government_position_held/jurisdiction_of_office	Buenos_Aires
Quest_for_Fire	/film/film/release_date_s./film/film_regional_release_date/film_release_region	Finland
Joshua_Redman	/award/award_winner/awards_won./award/award_honor/award_winner	Alison_Krauss
New_Year's_Eve	/film/film/release_date_s./film/film_regional_release_date/film_release_region	Georgia
Touchstone_Pictures	/film/film_distributor/films_distributed./film/film_film_distributor_relationship/film	Rushmore
Jewish_people	/people/ethnicity/people	Patricia_Arquette
Patrick_Gallagher	/award/award_nominee/award_nominations./award/award_nomination/award_nominee	Jenna_Ushkowitz
Topaz	/film/film/language	Spanish
Russian_Civil_War	/base/culturalevent/event/entity_involved	Second_Polish_Republic
African_Americans	/people/ethnicity/people	Static_Major
Jamie_Gangel	/people/person/profession	journalist
Katy_Perry	/people/person/profession	singer-songwriter
The_Kite_Runner	/award/award_winning_work/awards_won./award/award_honor/award_winner	Alberto_Iglesias
Dan_Castellaneta	/people/person/profession	comedian
Russian_Civil_War	/military/military_conflict/combatants./military/military_combatant_group/combatants	Second_Polish_Republic
baritone_guitar	/music/performance_role/regular_performances./music/group_membership/role	trumpet
Red_State	/film/film/release_date_s./film/film_regional_release_date/film_regional_debut_venue	New_York_City
Ian_Fleming	/people/person/profession	journalist
Metallica	/award/award_nominee/award_nominations./award/award_nomination/award	MTV_Video_Music_Award_for_Best_Cinematography
Tobey_Maguire	/base/popstra/celebrity/dated./base/popstra/dated/participant	Nicole_Richie
The_Insider	/film/film/music	Lisa_Gerrard
mayor	/government/government_office_category/officeholders./government/government_position_held/jurisdiction_of_office	Chicago
Golden_Satellite_Awards_2004	/award/award_ceremony/awards_presented./award/award_honor/honored_for	Sideways
Dallas	/base/popstra/location/vacationers./base/popstra/vacation_choice/vacationer	Alex_Rodriguez
drone_music	/music/genre/artists	Lou_Reed
Europe	/location/location/contains	Switzerland
Parks_and_Recreation	/tv/tv_program/genre	comedy-drama
Academy_Award_for_Best_Picture	/award/award_category/nominees./award/award_nomination/nominated_for	Cabaret
Christian_Bale	/award/award_nominee/award_nominations./award/award_nomination/award_nominee	Gretchen_Mol
Tracey_Ullman	/award/award_nominee/award_nominations./award/award_nomination/award_nominee	James_L._Brooks
John_Astin	/people/person/religion	Buddhism
University_of_Manchester	/education/educational_institution/school_type	university
Paramount_Pictures	/film/film_distributor/films_distributed./film/film_film_distributor_relationship/film	Death_on_the_Nile
Yo-Yo_Ma	/award/award_nominee/award_nominations./award/award_nomination/award_nominee	Alison_Krauss
Robert_Duvall	/film/actor/film./film/performance/film	Deep_Impact
Independent_Spirit_Award_for_Best_First_Screenplay	/award/award_category/nominees./award/award_nomination/nominated_for	Monster
California_State_University,_Sacramento	/education/educational_institution/students_graduates./education/education/student	Creed_Bratton
Corinne_Bailey_Rae	/people/person/profession	singer-songwriter
Saul_Bellow	/influence/influence_node/influenced_by	Joseph_Conrad
Dwight_Yoakam	/base/popstra/celebrity/dated./base/popstra/dated/participant	Bridget_Fonda
Russian_Civil_War	/time/event/locations	Finland
Benicio_del_Toro	/film/actor/film./film/performance/film	21_Grams
slapstick	/media_common/netflix_genre/titles	It's_a_Mad,_Mad,_Mad,_Mad_World
Canada	/olympics/olympic_participating_country/medals_won./olympics/olympic_medal_honor/olympics	1984_Summer_Olympics
Natasha_Richardson	/people/person/places_lived./people/place_lived/location	New_York_City
National_Society_of_Film_Critics_Award_for_Best_Actress	/award/award_category/nominees./award/award_nomination/nominated_for	Carrie
Sofia_Coppola	/award/award_nominee/award_nominations./award/award_nomination/award	MTV_Movie_Award_for_Best_New_Filmmaker
2007_NBA_Draft	/sports/sports_league_draft/picks./sports/sports_league_draft_pick/school	University_of_Pittsburgh
Summer_Wars	/film/film/genre	action_film
Love_Actually	/film/film/language	French
Howard_County	/location/location/contains	Columbia
Kathleen_Kennedy	/people/person/places_lived./people/place_lived/location	Berkeley
Rushmore	/film/film/language	Spanish
Paranormal_Activity	/film/film/release_date_s./film/film_regional_release_date/film_release_region	Switzerland
Mary-Louise_Parker	/film/actor/film./film/performance/film	Red_Dragon
Bob_Rafelson	/people/person/place_of_birth	New_York_City
The_French_Connection	/film/film/film_format	35_mm_film
Red_State	/film/film/film_festivals	2011_Sundance_Film_Festival
Shakira	/award/award_nominee/award_nominations./award/award_nomination/award_nominee	Katy_Perry
Frances_Conroy	/award/award_nominee/award_nominations./award/award_nomination/nominated_for	Six_Feet_Under
Kristin_Scott_Thomas	/award/award_winner/awards_won./award/award_honor/award_winner	Charles_Dance
Ben-Hur	/film/film/genre	action_film
Dwight_Yoakam	/award/award_nominee/award_nominations./award/award_nomination/award_nominee	Alison_Krauss
Goya_Award_for_Best_Film	/award/award_category/disciplines_or_subjects	film
The_Duchess	/film/film/executive_produced_by	Christine_Langan
contemporary_R&B	/music/genre/artists	Joss_Stone
Forrest_Gump	/award/award_winning_work/awards_won./award/award_honor/award_winner	Robert_Zemeckis
University_of_Dhaka	/education/educational_institution/school_type	public_university
president	/government/government_office_category/officeholders./government/government_position_held/jurisdiction_of_office	Second_Polish_Republic
Doubt	/film/film/featured_film_locations	New_York_City
popular_music	/music/genre/artists	London_Symphony_Orchestra
MTV_Movie_Award_for_Best_New_Filmmaker	/award/award_category/winners./award/award_honor/award_winner	Sofia_Coppola
African_Americans	/people/ethnicity/people	Toni_Morrison
African_Americans	/people/ethnicity/people	Stephen_Jackson
Invictus	/film/film/film_format	35_mm_film
The_Lord_of_the_Rings:_The_Fellowship_of_the_Ring	/film/film/genre	action_film
lung_cancer	/people/cause_of_death/people	Feroz_Khan
Robert_Shaw	/film/actor/film./film/performance/film	Jaws
Latin_Grammy_Award_for_Song_of_the_Year	/award/award_category/winners./award/award_honor/ceremony	Latin_Grammy_Awards_of_2004
Columbia_College_Chicago	/education/educational_institution/colors	grey
Philip_Baker_Hall	/film/actor/film./film/performance/film	The_Insider
Washington,_D.C.	/sports/sports_team_location/teams	Washington_Nationals
Columbia_College_Chicago	/education/educational_institution/school_type	private_university
Jewish_people	/people/ethnicity/people	Eli_Wallach
Sayaji_Shinde	/award/award_nominee/award_nominations./award/award_nomination/award	Filmfare_Award_for_Best_Supporting_Actor
Martine_McCutcheon	/award/award_nominee/award_nominations./award/award_nomination/award_nominee	Sienna_Guillory
Calendar_Girls	/film/film/production_companies	Touchstone_Pictures
The_Philadelphia_Story	/film/film/produced_by	Joseph_L._Mankiewicz
StudioCanal	/business/business_operation/industry	film
Kirk_Franklin	/people/person/places_lived./people/place_lived/location	Fort_Worth
Raghu_Babu	/people/person/profession	comedian
Mark_Mancina	/award/award_nominee/award_nominations./award/award_nomination/nominated_for	Training_Day
Kristin_Scott_Thomas	/people/person/languages	French
The_White_Stripes	/award/award_nominee/award_nominations./award/award_nomination/award	MTV_Video_Music_Award_for_Best_Cinematography
Rugby_School	/education/educational_institution/colors	white
Patricia_Arquette	/film/actor/film./film/performance/film	Searching_for_Debra_Winger
Yankee_Doodle_Dandy	/film/film/genre	biography
Dan_Aykroyd	/film/actor/film./film/performance/film	Ghostbusters_II
In_the_Mood_for_Love	/film/film/language	French
Transformers	/film/film/production_companies	Paramount_Pictures
Paramount_Pictures	/award/award_nominee/award_nominations./award/award_nomination/nominated_for	The_Heiress
Fred_Willard	/film/actor/film./film/performance/film	Chicken_Little
suicide	/people/cause_of_death/people	Elliott_Smith
Tough_Guys_Don't_Dance	/film/film/produced_by	Yoram_Globus
Ramones	/music/artist/origin	New_York_City
Dwight_Yoakam	/award/award_nominee/award_nominations./award/award_nomination/award_nominee	Randy_Travis
Transformers	/film/film/language	Spanish
Transformers	/film/film/release_date_s./film/film_regional_release_date/film_release_region	Pakistan
vibraphone	/music/performance_role/regular_performances./music/group_membership/role	trumpet
Guy_Pearce	/award/award_nominee/award_nominations./award/award_nomination/award_nominee	Anthony_Mackie
Hugh_Hefner	/people/person/profession	journalist
aviation	/film/film_subject/films	Pearl_Harbor
Chris_Tucker	/award/award_nominee/award_nominations./award/award_nomination/award	Golden_Raspberry_Award_for_Worst_New_Star
Academy_Award_for_Best_Picture	/award/award_category/winners./award/award_honor/ceremony	47th_Academy_Awards
Pearl_Harbor	/film/film/produced_by	Jerry_Bruckheimer
Stephen_King	/influence/influence_node/influenced_by	J._R._R._Tolkien
Yo-Yo_Ma	/award/award_winner/awards_won./award/award_honor/award_winner	Chris_Botti
The_French_Connection	/film/film/featured_film_locations	Washington,_D.C.
Sanjay_Dutt	/people/person/spouse_s./people/marriage/location_of_ceremony	New_York_City
contemporary_R&B	/music/genre/artists	Christina_Aguilera
Edward_R._Pressman	/people/person/places_lived./people/place_lived/location	New_York_City
The_Untouchables	/film/film/production_companies	Paramount_Pictures
47th_Academy_Awards	/award/award_ceremony/awards_presented./award/award_honor/award_winner	Robert_De_Niro
National_Society_of_Film_Critics_Award_for_Best_Actress	/award/award_category/winners./award/award_honor/award_winner	Kirsten_Dunst
20th_Century_Fox	/film/film_distributor/films_distributed./film/film_film_distributor_relationship/film	Willow
Gretchen_Mol	/film/actor/film./film/performance/film	Celebrity
president	/government/government_office_category/officeholders./government/government_position_held/jurisdiction_of_office	Benin
The_Lord_of_the_Rings:_The_Fellowship_of_the_Ring	/film/film/written_by	Peter_Jackson
Joseph_L._Mankiewicz	/award/award_nominee/award_nominations./award/award_nomination/nominated_for	The_Philadelphia_Story
Edward_Kitsis	/award/award_winner/awards_won./award/award_honor/award_winner	J._J._Abrams
Liam_Neeson	/award/award_nominee/award_nominations./award/award_nomination/award_nominee	Chiwetel_Ejiofor
John_Frink	/award/award_nominee/award_nominations./award/award_nomination/award_nominee	James_L._Brooks
Norbit	/film/film/genre	slapstick
Ellen_Pompeo	/award/award_nominee/award_nominations./award/award_nomination/award_nominee	Kate_Walsh
Pompano_Beach	/location/hud_county_place/county	Broward_County
Tough_Guys_Don't_Dance	/film/film/genre	comedy-drama
Pearl_Harbor	/film/film/genre	action_film
Amber_Riley	/award/award_winner/awards_won./award/award_honor/award_winner	Patrick_Gallagher
The_Lord_of_the_Rings:_The_Fellowship_of_the_Ring	/film/film/story_by	J._R._R._Tolkien
William_Friedkin	/people/person/place_of_birth	Chicago
Joseph_Heller	/influence/influence_node/influenced_by	William_Faulkner
Sicko	/film/film/personal_appearances./film/personal_film_appearance/person	Richard_Nixon
Patricia_Arquette	/film/actor/film./film/performance/film	Lost_Highway
51st_Academy_Awards	/award/award_ceremony/awards_presented./award/award_honor/honored_for	The_Deer_Hunter
Chris_Columbus	/award/award_nominee/award_nominations./award/award_nomination/award	Academy_Award_for_Best_Picture
Rwanda	/location/country/official_language	French
John_Barrowman	/film/actor/film./film/performance/film	The_Untouchables
Paul_Auster	/award/award_nominee/award_nominations./award/award_nomination/award	Independent_Spirit_Award_for_Best_First_Screenplay
Bill_Pullman	/film/actor/film./film/performance/film	Lost_Highway
Ricky_Gervais	/people/person/profession	comedian
Doc_Watson	/award/award_nominee/award_nominations./award/award_nomination/award_nominee	Nitty_Gritty_Dirt_Band
progressive_bluegrass	/music/genre/artists	Alison_Krauss
Howl's_Moving_Castle	/film/film/genre	action_film
road_cycling	/olympics/olympic_sport/athletes./olympics/olympic_athlete_affiliation/country	Switzerland
University_of_New_Mexico	/education/educational_institution/students_graduates./education/education/major_field_of_study	art_history
Jewish_people	/people/ethnicity/people	Rachel_Weisz
J._K._Rowling	/people/person/places_lived./people/place_lived/location	Porto
San_Diego_State_Aztecs_football	/sports/sports_team/roster./american_football/football_historical_roster_position/position_s	running_back
Elite_Squad:_The_Enemy_Within	/film/film/release_date_s./film/film_regional_release_date/film_regional_debut_venue	Chicago
Travis_Barker	/people/person/profession	drummer
Peter_Jackson	/film/actor/film./film/performance/film	The_Lord_of_the_Rings:_The_Fellowship_of_the_Ring
D'Angelo	/people/person/profession	singer-songwriter
Henry_King	/film/director/film	Love_Is_a_Many-Splendored_Thing
Frances_Conroy	/film/actor/film./film/performance/film	The_Crucible
Senna	/film/film/film_festivals	2011_Sundance_Film_Festival
Sienna_Guillory	/film/actor/film./film/performance/film	Love_Actually
James_Stewart	/base/popstra/celebrity/dated./base/popstra/dated/participant	Olivia_de_Havilland
Lost_in_Translation	/film/film/genre	comedy-drama
Bing_Crosby	/people/person/profession	singer-songwriter
Academy_Award_for_Best_Picture	/award/award_category/nominees./award/award_nomination/nominated_for	The_Nun's_Story
Academy_Award_for_Best_Picture	/award/award_category/winners./award/award_honor/award_winner	/m/02kxbwx
Lost_in_Translation	/award/award_winning_work/awards_won./award/award_honor/award_winner	Sofia_Coppola
Anthony_Mackie	/award/award_nominee/award_nominations./award/award_nomination/award_nominee	Guy_Pearce
reggae	/music/genre/artists	Damian_Marley
1941	/film/film/genre	action_film
Bowling_for_Columbine	/film/film/country	Canada
Catherine_O'Hara	/people/person/nationality	Canada
57th_Golden_Globe_Awards	/award/award_ceremony/awards_presented./award/award_honor/honored_for	Toy_Story_2
Jewish_people	/people/ethnicity/people	James_L._Brooks
James_Baldwin	/influence/influence_node/peers./influence/peer_relationship/peers	Nina_Simone
English_Civil_War	/time/event/locations	Kingdom_of_England
Tim_Roth	/award/award_nominee/award_nominations./award/award_nomination/award	BAFTA_Award_for_Best_Actor_in_a_Supporting_Role
Canada	/olympics/olympic_participating_country/athletes./olympics/olympic_athlete_affiliation/olympics	1984_Summer_Olympics
Roger_Zelazny	/influence/influence_node/influenced_by	Jack_Vance
Academy_Award_for_Best_Picture	/award/award_category/nominees./award/award_nomination/nominated_for	The_Green_Mile
Dirty_Dancing	/film/film/release_date_s./film/film_regional_release_date/film_release_region	Canada
Bernadette_Peters	/people/person/profession	comedian
Benicio_del_Toro	/award/award_nominee/award_nominations./award/award_nomination/award	BAFTA_Award_for_Best_Actor_in_a_Supporting_Role
Don_Henley	/award/award_nominee/award_nominations./award/award_nomination/award_nominee	Glenn_Frey
Fred_Quimby	/award/award_nominee/award_nominations./award/award_nomination/award	Academy_Award_for_Best_Animated_Short_Film
Peter_Riegert	/award/award_nominee/award_nominations./award/award_nomination/award_nominee	James_Brolin
mayor	/government/government_office_category/officeholders./government/government_position_held/jurisdiction_of_office	Berkeley
Toni_Morrison	/people/person/places_lived./people/place_lived/location	New_York_City
Southern_rock	/music/genre/artists	Hank_Williams_Jr.
Adaptation	/film/film/genre	cult_film
The_Deer_Hunter	/film/film/cinematography	Vilmos_Zsigmond
Six_Feet_Under	/tv/tv_program/genre	comedy-drama
Knight_and_Day	/film/film/film_format	35_mm_film
Korea	/location/location/contains	North_Korea
Ned_Beatty	/film/actor/film./film/performance/film	1941
Americana	/music/genre/artists	Steve_Earle
Kingdom_of_the_Netherlands	/location/country/form_of_government	parliamentary_system
Robbie_Coltrane	/award/award_nominee/award_nominations./award/award_nomination/award	BAFTA_Award_for_Best_Actor_in_a_Supporting_Role
Northern_Illinois_University	/education/educational_institution/school_type	public_university
Groningen	/location/location/adjoin_s./location/adjoining_relationship/adjoins	Friesland
Robert_Zemeckis	/people/person/place_of_birth	Chicago
pneumonia	/medicine/disease/risk_factors	alcoholism
Ferris_Bueller's_Day_Off	/film/film/release_date_s./film/film_regional_release_date/film_release_region	Finland
Forrest_Gump	/award/award_winning_work/awards_won./award/award_honor/award	Academy_Award_for_Best_Picture
Canada	/location/location/contains	Windsor
University_of_California,_Los_Angeles	/education/educational_institution/school_type	public_university
Amber_Riley	/award/award_nominee/award_nominations./award/award_nomination/award_nominee	Jenna_Ushkowitz
Kathleen_Kennedy	/award/award_winner/awards_won./award/award_honor/award_winner	Paramount_Pictures
The_McClatchy_Company	/organization/organization/headquarters./location/mailing_address/citytown	Sacramento
Tobey_Maguire	/award/award_nominee/award_nominations./award/award_nomination/award_nominee	Kirsten_Dunst
89th_United_States_Congress	/government/legislative_session/members./government/government_position_held/legislative_sessions	99th_United_States_Congress
Switzerland	/olympics/olympic_participating_country/medals_won./olympics/olympic_medal_honor/olympics	1964_Summer_Olympics
Paramount_Pictures	/award/award_nominee/award_nominations./award/award_nomination/award	Academy_Award_for_Best_Picture
David_Letterman	/base/popstra/celebrity/dated./base/popstra/dated/participant	Teri_Garr
biography	/media_common/netflix_genre/titles	Ali
Howl's_Moving_Castle	/film/film/genre	steampunk
Boris_Karloff	/people/person/places_lived./people/place_lived/location	Canada
Nixon	/film/film/genre	biography
Matthew_Broderick	/award/award_nominee/award_nominations./award/award_nomination/nominated_for	Ferris_Bueller's_Day_Off
Hong_Kong_Film_Award_for_Best_New_Performer	/award/award_category/disciplines_or_subjects	film
Academy_Award_for_Best_Picture	/award/award_category/nominees./award/award_nomination/nominated_for	The_Heiress
Grown_Ups	/award/award_winning_work/awards_won./award/award_honor/award_winner	Adam_Sandler
Alabama_Crimson_Tide_football	/sports/sports_team/roster./american_football/football_historical_roster_position/position_s	running_back
Jewish_people	/people/ethnicity/people	Doris_Roberts
Easy_Rider	/film/film/release_date_s./film/film_regional_release_date/film_release_region	Finland
Kathleen_Kennedy	/award/award_nominee/award_nominations./award/award_nomination/award_nominee	Paramount_Pictures
Bob_Geldof	/people/person/profession	singer-songwriter
death_metal	/music/genre/artists	Devin_Townsend
Some_Kind_of_Monster	/film/film/release_date_s./film/film_regional_release_date/film_release_region	Canada
West_Berkshire	/base/aareas/schema/administrative_area/administrative_parent	Berkshire
Jon_Brion	/music/artist/track_contributions./music/track_contribution/role	baritone_guitar
Christian_Bale	/award/award_nominee/award_nominations./award/award_nomination/award_nominee	Peter_Fonda
John_Astin	/people/person/employment_history./business/employment_tenure/company	Johns_Hopkins_University
J._J._Abrams	/people/person/places_lived./people/place_lived/location	Pacific_Palisades
Paramount_Pictures	/film/film_distributor/films_distributed./film/film_film_distributor_relationship/film	Deep_Impact
The_Deer_Hunter	/film/film/language	French
This_Is_Spinal_Tap	/film/film/genre	cult_film
Charles_Pratt	/award/award_nominee/award_nominations./award/award_nomination/award_nominee	Robert_Guza,_Jr.
VfL_Wolfsburg	/sports/sports_team/colors	white
Al_Franken	/award/award_winner/awards_won./award/award_honor/award_winner	Paul_Reubens
Academy_Award_for_Best_Picture	/award/award_category/nominees./award/award_nomination/nominated_for	Sideways
Jeffrey_Wright	/people/person/places_lived./people/place_lived/location	Washington,_D.C.
trumpet	/music/performance_role/regular_performances./music/group_membership/role	vibraphone
Lenny_Kravitz	/people/person/place_of_birth	New_York_City
Charles_Dance	/award/award_nominee/award_nominations./award/award_nomination/award_nominee	Kristin_Scott_Thomas
Rushmore	/award/award_winning_work/awards_won./award/award_honor/award	Independent_Spirit_Award_for_Best_Director
Chris_Cooper	/award/award_nominee/award_nominations./award/award_nomination/award_nominee	Tobey_Maguire
Tobey_Maguire	/base/popstra/celebrity/dated./base/popstra/dated/participant	Kirsten_Dunst
Tobey_Maguire	/award/award_winner/awards_won./award/award_honor/award_winner	Kirsten_Dunst
Joseph_Kish	/film/film_set_designer/film_sets_designed	It's_a_Mad,_Mad,_Mad,_Mad_World
Colleen_Dewhurst	/people/person/nationality	Canada
Golden_Satellite_Awards_2004	/award/award_ceremony/awards_presented./award/award_honor/award_winner	Michael_Minkler
viola	/music/performance_role/regular_performances./music/group_membership/role	washboard
Touchstone_Pictures	/film/film_distributor/films_distributed./film/film_film_distributor_relationship/film	Signs
viola	/music/performance_role/track_performances./music/track_contribution/role	double_bass
William_Petersen	/award/award_winner/awards_won./award/award_honor/award_winner	Paul_Guilfoyle
The_Book_of_Eli	/film/film/genre	action_film
Shaun_of_the_Dead	/film/film/production_companies	StudioCanal
Thomas_Pynchon	/award/award_nominee/award_nominations./award/award_nomination/award	Nebula_Award_for_Best_Novel
Patrick_Gallagher	/award/award_nominee/award_nominations./award/award_nomination/award_nominee	Josh_Sussman
Adam_Sandler	/base/popstra/celebrity/friendship./base/popstra/friendship/participant	Kevin_James
Robert_De_Niro	/film/actor/film./film/performance/film	15_Minutes
Butch_Cassidy_and_the_Sundance_Kid	/film/film/genre	action_film
Alison_Krauss	/award/award_winner/awards_won./award/award_honor/award_winner	Robert_Plant
Jackass_Number_Two	/film/film/production_companies	Paramount_Pictures
Paramount_Pictures	/film/film_distributor/films_distributed./film/film_film_distributor_relationship/film	Tucker:_The_Man_and_His_Dream
57th_Golden_Globe_Awards	/award/award_ceremony/awards_presented./award/award_honor/award_winner	Peter_Fonda
African_Americans	/people/ethnicity/people	Tyrese_Gibson
Thomas_Pynchon	/influence/influence_node/influenced_by	Saul_Bellow
Jane_Campion	/film/director/film	Bright_Star
Paul_Reubens	/people/person/profession	comedian
contemporary_R&B	/music/genre/artists	Kelis
William_Faulkner	/influence/influence_node/influenced_by	Joseph_Conrad
The_McClatchy_Company	/business/business_operation/industry	newspaper
Paramount_Pictures	/film/film_distributor/films_distributed./film/film_film_distributor_relationship/film	Blue_Velvet
Tunisia	/olympics/olympic_participating_country/medals_won./olympics/olympic_medal_honor/olympics	1964_Summer_Olympics
Sienna_Guillory	/award/award_nominee/award_nominations./award/award_nomination/award_nominee	Martine_McCutcheon
Tobey_Maguire	/base/popstra/celebrity/canoodled./base/popstra/canoodled/participant	Christina_Aguilera
Speed	/film/film/production_companies	20th_Century_Fox
J._K._Rowling	/influence/influence_node/influenced_by	Stephen_King
Robert_Duvall	/award/award_nominee/award_nominations./award/award_nomination/award_nominee	Dwight_Yoakam
Bridget_Fonda	/base/popstra/celebrity/dated./base/popstra/dated/participant	Dwight_Yoakam
Homeland	/award/award_winning_work/awards_won./award/award_honor/award	Screen_Actors_Guild_Award_for_Outstanding_Performance_by_a_Female_Actor_in_a_Drama_Series
Dead_Man_Walking	/film/film/cinematography	Roger_Deakins
Downfall	/film/film/genre	biography
president	/government/government_office_category/officeholders./government/government_position_held/jurisdiction_of_office	Niger
Joseph_L._Mankiewicz	/people/person/places_lived./people/place_lived/location	New_York_City
52nd_Annual_Grammy_Awards	/award/award_ceremony/awards_presented./award/award_honor/award_winner	Chris_Thile
European_theatre_of_World_War_I	/time/event/locations	Europe
Julianna_Margulies	/film/actor/film./film/performance/film	The_Newton_Boys
mayor	/government/government_office_category/officeholders./government/government_position_held/jurisdiction_of_office	Chesapeake
Kristin_Scott_Thomas	/film/actor/film./film/performance/film	Salmon_Fishing_in_the_Yemen
trumpet	/music/performance_role/regular_performances./music/group_membership/role	baritone_guitar
Nathan_Lane	/people/person/places_lived./people/place_lived/location	New_York_City
Spanish	/language/human_language/countries_spoken_in	Canada
broccoli	/food/food/nutrients./food/nutrition_fact/nutrient	DL-proline
Battle_Royale	/film/film/release_date_s./film/film_regional_release_date/film_release_region	Finland
Kikuko_Inoue	/people/person/profession	singer-songwriter
president	/business/job_title/people_with_this_title./business/employment_tenure/company	20th_Century_Fox
lung_cancer	/medicine/disease/risk_factors	tobacco_smoking
Static_Major	/people/person/profession	singer-songwriter
Busta_Rhymes	/award/award_nominee/award_nominations./award/award_nomination/award_nominee	Static_Major
Robert_Gates	/people/person/employment_history./business/employment_tenure/company	Johns_Hopkins_University
Kristin_Scott_Thomas	/award/award_winner/awards_won./award/award_honor/award_winner	Helen_Mirren
Deep_Impact	/film/film/featured_film_locations	New_York_City
43rd_Academy_Awards	/award/award_ceremony/awards_presented./award/award_honor/honored_for	MASH
Tulane_University_Law_School	/organization/organization/headquarters./location/mailing_address/state_province_region	Louisiana
National_Theatre_School_of_Canada	/education/educational_institution/students_graduates./education/education/student	Patrick_Gallagher
Michael_Moorcock	/influence/influence_node/influenced_by	Joseph_Conrad
Chicago	/location/location/contains	University_of_Chicago_Law_School
judo	/olympics/olympic_sport/athletes./olympics/olympic_athlete_affiliation/olympics	1964_Summer_Olympics
Charles_Dance	/award/award_winner/awards_won./award/award_honor/award_winner	Helen_Mirren
Gone_with_the_Wind	/award/award_winning_work/awards_won./award/award_honor/award	Academy_Award_for_Best_Picture
Katy_Perry	/film/actor/film./film/performance/film	The_Muppets
Ben-Hur	/award/award_winning_work/awards_won./award/award_honor/award	Academy_Award_for_Best_Picture
H._G._Wells	/influence/influence_node/influenced_by	Jules_Verne
Ninotchka	/film/film/executive_produced_by	Ernst_Lubitsch
Jewish_people	/people/ethnicity/people	Mike_Nichols
Waterworld	/award/award_nominated_work/award_nominations./award/award_nomination/nominated_for	The_Postman
Kevin_James	/people/person/profession	comedian
Lili_Taylor	/film/actor/film./film/performance/film	Four_Rooms
Golden_Satellite_Awards_2004	/award/award_ceremony/awards_presented./award/award_honor/honored_for	Ashley_Palacios
Peter_Fonda	/award/award_nominee/award_nominations./award/award_nomination/award_nominee	Gretchen_Mol
Matthew_Broderick	/people/person/places_lived./people/place_lived/location	New_York_City
Grammy_Award_for_Best_Traditional_Blues_Album	/award/award_category/winners./award/award_honor/award_winner	John_Lee_Hooker
Duran_Duran	/award/award_nominee/award_nominations./award/award_nomination/award	MTV_Video_Music_Award_for_Best_Cinematography
21st_Academy_Awards	/award/award_ceremony/awards_presented./award/award_honor/award_winner	John_Huston
J._J._Abrams	/award/award_nominee/award_nominations./award/award_nomination/award_nominee	Edward_Kitsis
Nitty_Gritty_Dirt_Band	/award/award_nominee/award_nominations./award/award_nomination/award_nominee	Doc_Watson
Alison_Krauss	/award/award_winner/awards_won./award/award_honor/award_winner	Chris_Botti
Hewlett-Packard	/business/business_operation/industry	software
Paramount_Pictures	/film/film_distributor/films_distributed./film/film_film_distributor_relationship/film	Some_Kind_of_Monster
African_Americans	/people/ethnicity/people	Ving_Rhames
biography	/media_common/netflix_genre/titles	Yankee_Doodle_Dandy
Kristin_Scott_Thomas	/award/award_nominee/award_nominations./award/award_nomination/award_nominee	Helen_Mirren
mayor	/government/government_office_category/officeholders./government/government_position_held/jurisdiction_of_office	New_York_City
Elliott_Smith	/people/person/profession	singer-songwriter
Battle_Royale	/film/film/release_date_s./film/film_regional_release_date/film_regional_debut_venue	New_York_City
EMI_Records	/music/record_label/artist	Depeche_Mode
Meg_Ryan	/award/award_nominee/award_nominations./award/award_nomination/nominated_for	City_of_Angels
Robert_Duvall	/film/actor/film./film/performance/film	MASH
Jane_Campion	/award/award_nominee/award_nominations./award/award_nomination/nominated_for	Bright_Star
Helen_Mirren	/award/award_nominee/award_nominations./award/award_nomination/nominated_for	The_Last_Station
Finland	/location/location/contains	Turku
Golden_Raspberry_Award_for_Worst_New_Star	/award/award_category/winners./award/award_honor/award_winner	Sofia_Coppola
New_York_City	/base/popstra/location/vacationers./base/popstra/vacation_choice/vacationer	Kirsten_Dunst
quiet_storm	/music/genre/artists	The_Isley_Brothers
1941	/film/film/written_by	Robert_Zemeckis
Jewish_people	/people/ethnicity/people	Helena_Bonham_Carter
Willamette_University	/organization/organization/headquarters./location/mailing_address/citytown	Salem
pneumonia	/people/cause_of_death/people	Robert_Schumann
Patrick_Gallagher	/people/person/nationality	Canada
Academy_Award_for_Best_Picture	/award/award_category/winners./award/award_honor/award_winner	Peter_Jackson
Debbie_Harry	/people/person/profession	singer-songwriter
pneumonia	/people/cause_of_death/people	Billy_Wilder
vice_president	/business/job_title/people_with_this_title./business/employment_tenure/company	Ford
102nd_United_States_Congress	/government/legislative_session/members./government/government_position_held/legislative_sessions	106th_United_States_Congress
Mike_Nichols	/people/person/profession	theatrical_producer
Helena_Bonham_Carter	/award/award_winner/awards_won./award/award_honor/award_winner	Guy_Pearce
Peter_Falk	/people/person/place_of_birth	New_York_City
JPMorgan_Chase	/organization/organization/place_founded	New_York_City
Ellen_Barkin	/film/actor/film./film/performance/film	She_Hate_Me
Six_Feet_Under	/award/award_winning_work/awards_won./award/award_honor/award_winner	Frances_Conroy
Steven_Wilson	/music/artist/track_contributions./music/track_contribution/role	electric_piano
The_Bourne_Supremacy	/film/film/genre	action_film
Dean_Devlin	/people/person/place_of_birth	New_York_City
Chicago	/sports/sports_team_location/teams	Chicago_Blackhawks
Olivia_de_Havilland	/award/award_nominee/award_nominations./award/award_nomination/nominated_for	Gone_with_the_Wind
Academy_Award_for_Best_Picture	/award/award_category/winners./award/award_honor/ceremony	21st_Academy_Awards
Mandy_Patinkin	/award/award_nominee/award_nominations./award/award_nomination/award_nominee	Damian_Lewis
University_of_California,_Los_Angeles	/education/educational_institution/students_graduates./education/education/major_field_of_study	film
The_Philadelphia_Story	/award/award_winning_work/awards_won./award/award_honor/award_winner	Katharine_Hepburn
Ellen_Pompeo	/award/award_nominee/award_nominations./award/award_nomination/award_nominee	Chandra_Wilson
Independent_Spirit_Award_for_Best_Director	/award/award_category/winners./award/award_honor/award_winner	Sofia_Coppola
Colleen_Dewhurst	/award/award_nominee/award_nominations./award/award_nomination/nominated_for	Murphy_Brown
Academy_Award_for_Best_Picture	/award/award_category/nominees./award/award_nomination/nominated_for	The_Guns_of_Navarone
Haskell_Wexler	/people/person/place_of_birth	Chicago
Michael_Moore	/award/award_nominee/award_nominations./award/award_nomination/nominated_for	Sicko
Chris_Thile	/award/award_nominee/award_nominations./award/award_nomination/award_nominee	Yo-Yo_Ma
Doc_Watson	/award/award_nominee/award_nominations./award/award_nomination/award_nominee	Alison_Krauss
In_the_Mood_for_Love	/award/award_winning_work/awards_won./award/award_honor/award_winner	Wong_Kar-wai
Lucille_Ball	/people/person/profession	comedian
Grammy_Award_for_Best_Latin_Pop_Album	/award/award_category/winners./award/award_honor/award_winner	Shakira
Norman_Blake	/award/award_nominee/award_nominations./award/award_nomination/award_nominee	Ralph_Stanley
The_Last_Station	/film/film/genre	biography
Academy_Award_for_Best_Animated_Short_Film	/award/award_category/winners./award/award_honor/ceremony	43rd_Academy_Awards
Rod_Serling	/people/person/places_lived./people/place_lived/location	Syracuse
Motherland	/film/film/featured_film_locations	Addis_Ababa
Independent_Spirit_Award_for_Best_Director	/award/award_category/nominees./award/award_nomination/nominated_for	Lost_in_Translation
103rd_United_States_Congress	/government/legislative_session/members./government/government_position_held/legislative_sessions	99th_United_States_Congress
The_Muppets	/film/film/release_date_s./film/film_regional_release_date/film_release_region	Malta
Sicko	/film/film/featured_film_locations	New_York_City
Game_of_Thrones	/tv/tv_program/regular_cast./tv/regular_tv_appearance/actor	Charles_Dance
Matthew_Broderick	/film/actor/film./film/performance/film	Ferris_Bueller's_Day_Off
Maya_Angelou	/influence/influence_node/influenced_by	James_Baldwin
Jewish_people	/people/ethnicity/people	Lee_Grant
Chandra_Wilson	/award/award_nominee/award_nominations./award/award_nomination/award_nominee	James_Pickens
Liam_Neeson	/people/person/spouse_s./people/marriage/spouse	Natasha_Richardson
Charlie_Parker	/music/artist/track_contributions./music/track_contribution/role	alto_saxophone
2001_NCAA_Men's_Division_I_Basketball_Tournament	/base/marchmadness/ncaa_basketball_tournament/seeds./base/marchmadness/ncaa_tournament_seed/team	Illinois_Fighting_Illini_men's_basketball
Chandra_Wilson	/award/award_nominee/award_nominations./award/award_nomination/award	Screen_Actors_Guild_Award_for_Outstanding_Performance_by_a_Female_Actor_in_a_Drama_Series
Paramount_Pictures	/film/film_distributor/films_distributed./film/film_film_distributor_relationship/film	Jackass_Number_Two
Anne_McCaffrey	/people/person/place_of_birth	Cambridge
viola	/music/instrument/family	string_instrument
Paul_Guilfoyle	/award/award_winner/awards_won./award/award_honor/award_winner	William_Petersen
Helen_Mirren	/film/actor/film./film/performance/film	Calendar_Girls
Denzel_Washington	/award/award_nominee/award_nominations./award/award_nomination/award_nominee	Chiwetel_Ejiofor
Independent_Spirit_Award_for_Best_Director	/award/award_category/nominees./award/award_nomination/nominated_for	The_Artist
Colgate_University	/education/educational_institution/school_type	private_university
Signs	/film/film/executive_produced_by	Kathleen_Kennedy
North_Korea	/military/military_combatant/military_conflicts./military/military_combatant_group/combatants	National_Front_for_the_Liberation_of_South_Vietnam
biography	/media_common/netflix_genre/titles	Finding_Neverland
Paramount_Pictures	/film/film_distributor/films_distributed./film/film_film_distributor_relationship/film	Jackass_3D
Liam_Neeson	/film/actor/film./film/performance/film	Love_Actually
Old_Dominion_University	/education/educational_institution/school_type	public_university
Love_Actually	/award/award_winning_work/awards_won./award/award_honor/award_winner	Martine_McCutcheon
teen_drama	/media_common/netflix_genre/titles	Smallville
North_Carolina_Central_University	/education/educational_institution/school_type	public_university
thrash_metal	/music/genre/artists	Buckethead
Woodrow_Wilson	/government/politician/government_positions_held./government/government_position_held/basic_title	president
Speed	/film/film/produced_by	Mark_Gordon
Ashley_Judd	/film/actor/film./film/performance/film	A_Time_to_Kill
Ving_Rhames	/people/person/place_of_birth	New_York_City
Tracey_Ullman	/award/award_nominee/award_nominations./award/award_nomination/award_nominee	Sam_Simon
Dwight_Yoakam	/people/person/places_lived./people/place_lived/location	Columbus
slapstick	/media_common/netflix_genre/titles	Dumb_and_Dumber
David_Banner	/award/award_nominee/award_nominations./award/award_nomination/award_nominee	Static_Major
Wong_Kar-wai	/award/award_nominee/award_nominations./award/award_nomination/nominated_for	In_the_Mood_for_Love
Transformers	/film/film/written_by	Roberto_Orci
Moby	/people/person/profession	singer-songwriter
Europe	/location/location/contains	Malta
MTV_Video_Music_Award_for_Best_Cinematography	/award/award_category/winners./award/award_honor/award_winner	Don_Henley
Kate_Walsh	/award/award_winner/awards_won./award/award_honor/award_winner	Chandra_Wilson
Ghostbusters_II	/award/award_winning_work/awards_won./award/award_honor/award_winner	L.A._Reid
Mike_Mogis	/music/artist/track_contributions./music/track_contribution/role	baritone_guitar
Central_Michigan_University	/education/educational_institution/school_type	public_university
Terry_Crews	/people/person/profession	comedian
Academy_Award_for_Best_Animated_Short_Film	/award/award_category/winners./award/award_honor/ceremony	47th_Academy_Awards
Patricia_Heaton	/people/person/places_lived./people/place_lived/location	New_York_City
Gramercy_Pictures	/film/film_distributor/films_distributed./film/film_film_distributor_relationship/film	The_Adventures_of_Priscilla,_Queen_of_the_Desert
Bam_Margera	/film/actor/film./film/performance/film	Jackass_Number_Two
Mandy_Patinkin	/people/person/places_lived./people/place_lived/location	Chicago
The_Adventures_of_Priscilla,_Queen_of_the_Desert	/film/film/language	Filipino_language
Chris_Cooper	/award/award_nominee/award_nominations./award/award_nomination/nominated_for	Adaptation
Paramount_Pictures	/award/award_winner/awards_won./award/award_honor/award_winner	20th_Century_Fox
John_Huston	/award/award_nominee/award_nominations./award/award_nomination/award	Academy_Award_for_Best_Picture
BAFTA_Award_for_Best_Actor_in_a_Supporting_Role	/award/award_category/nominees./award/award_nomination/nominated_for	Adaptation
Claudette_Colbert	/base/popstra/celebrity/dated./base/popstra/dated/participant	Katharine_Hepburn
The_Heiress	/film/film/production_companies	Paramount_Pictures
Paramount_Pictures	/film/film_distributor/films_distributed./film/film_film_distributor_relationship/film	Paranormal_Activity
Shakira	/people/person/profession	singer-songwriter
Kirsten_Dunst	/base/popstra/celebrity/friendship./base/popstra/friendship/participant	Tobey_Maguire
20th_Century_Fox	/film/film_distributor/films_distributed./film/film_film_distributor_relationship/film	Love_Is_a_Many-Splendored_Thing
Clash_of_the_Titans	/film/film/other_crew./film/film_crew_gig/film_crew_role	storyboard_artist
The_Fast_and_the_Furious	/award/award_winning_work/awards_won./award/award_honor/award_winner	Paul_Walker
Chris_Cooper	/film/actor/film./film/performance/film	The_Muppets
Kingdom_of_the_Netherlands	/location/location/contains	Aruba
European_theatre_of_World_War_I	/military/military_conflict/combatants./military/military_combatant_group/combatants	Union_of_South_Africa
Louis_Malle	/award/award_nominee/award_nominations./award/award_nomination/award	BAFTA_Academy_Fellowship_Award
Joseph_L._Mankiewicz	/award/award_nominee/award_nominations./award/award_nomination/award	Academy_Award_for_Best_Picture
running_back	/sports/sports_position/players./sports/sports_team_roster/team	Michigan_State_Spartans_football
2007_NBA_Draft	/sports/sports_league_draft/picks./sports/sports_league_draft_pick/school	University_of_Kansas
/m/02kxbwx	/award/award_nominee/award_nominations./award/award_nomination/award	Independent_Spirit_Award_for_Best_Director
Sony_BMG	/music/record_label/artist	Shakira
Craig_Robinson	/people/person/profession	comedian
contemporary_R&B	/music/genre/artists	Ja_Rule
Jon_Voight	/award/award_nominee/award_nominations./award/award_nomination/nominated_for	Ali
102nd_United_States_Congress	/government/legislative_session/members./government/government_position_held/legislative_sessions	89th_United_States_Congress
Olivia_Newton-John	/award/award_nominee/award_nominations./award/award_nomination/award	Grammy_Award_for_Best_Female_Pop_Vocal_Performance
The_Spy_Who_Loved_Me	/film/film/genre	action_film
Patricia_Arquette	/people/person/place_of_birth	Chicago
Academy_Award_for_Best_Picture	/award/award_category/nominees./award/award_nomination/nominated_for	Coming_Home
Bright_Star	/film/film/genre	biography
Jamie-Lynn_Sigler	/award/award_nominee/award_nominations./award/award_nomination/award_nominee	Dan_Grimaldi
Denzel_Washington	/award/award_nominee/award_nominations./award/award_nomination/nominated_for	Philadelphia
Jewish_people	/people/ethnicity/people	Jamie-Lynn_Sigler
Some_Kind_of_Monster	/film/film/release_date_s./film/film_regional_release_date/film_release_region	Switzerland
Nicole_Richie	/people/person/place_of_birth	Berkeley
Dan_Grimaldi	/award/award_nominee/award_nominations./award/award_nomination/award_nominee	Jamie-Lynn_Sigler
Willamette_University	/education/educational_institution/school_type	private_university
defenceman	/sports/sports_position/players./sports/sports_team_roster/team	Nashville_Predators
Priest	/film/film/other_crew./film/film_crew_gig/film_crew_role	storyboard_artist
Clash_of_the_Titans	/film/film/genre	action_film
Gramercy_Pictures	/film/film_distributor/films_distributed./film/film_film_distributor_relationship/film	The_Portrait_of_a_Lady
Remember_the_Titans	/film/film/release_date_s./film/film_regional_release_date/film_release_region	Switzerland
National_Society_of_Film_Critics_Award_for_Best_Film	/award/award_category/nominees./award/award_nomination/nominated_for	Blue_Velvet
Touchstone_Pictures	/business/business_operation/industry	film
Washington,_D.C.	/location/statistical_region/religions./location/religion_percentage/religion	Buddhism
The_French_Connection	/film/film/language	French
Chris_Botti	/award/award_winner/awards_won./award/award_honor/award_winner	Yo-Yo_Ma
Jon_Voight	/film/actor/film./film/performance/film	Transformers
15_Minutes	/film/film/featured_film_locations	New_York_City
Robert_De_Niro	/film/actor/film./film/performance/film	New_Year's_Eve
French	/language/human_language/countries_spoken_in	Switzerland
Guy_Pearce	/film/actor/film./film/performance/film	Memento
Hayden_Christensen	/people/person/nationality	Canada
Manoj_Kumar	/people/person/nationality	Pakistan
Robert_Plant	/people/person/profession	singer-songwriter
Oregon_Ducks_football	/sports/sports_team/roster./american_football/football_historical_roster_position/position_s	running_back
viola	/music/performance_role/regular_performances./music/group_membership/role	double_bass
Jewish_people	/people/ethnicity/people	Dean_Devlin
Thunderball	/film/film/story_by	Ian_Fleming
Chris_Botti	/award/award_nominee/award_nominations./award/award_nomination/award_nominee	Chris_Thile
Forrest_Gump	/film/film/release_date_s./film/film_regional_release_date/film_release_region	Finland
Seattle_SuperSonics	/sports/professional_sports_team/draft_picks./sports/sports_league_draft_pick/school	University_of_California,_Los_Angeles
judo	/olympics/olympic_sport/athletes./olympics/olympic_athlete_affiliation/country	North_Korea
2006_NCAA_Men's_Division_I_Basketball_Tournament	/base/marchmadness/ncaa_basketball_tournament/seeds./base/marchmadness/ncaa_tournament_seed/team	Pittsburgh_Panthers_men's_basketball
Scott_Pilgrim_vs._the_World	/film/film/genre	action_film
Jerry_Orbach	/people/person/places_lived./people/place_lived/location	New_York_City
Kader_Khan	/people/person/nationality	Pakistan
New_York_City	/location/location/contains	Manhattan_College
Jewish_people	/people/ethnicity/people	Steve_Schirripa
Billy_Wilder	/award/award_nominee/award_nominations./award/award_nomination/award	BAFTA_Academy_Fellowship_Award
Ethan_Hawke	/award/award_nominee/award_nominations./award/award_nomination/award_nominee	Marisa_Tomei
The_Newton_Boys	/film/film/genre	action_film
Six_Feet_Under	/tv/tv_program/regular_cast./tv/regular_tv_appearance/actor	Frances_Conroy
Six_Feet_Under	/award/award_winning_work/awards_won./award/award_honor/award	Screen_Actors_Guild_Award_for_Outstanding_Performance_by_a_Female_Actor_in_a_Drama_Series
The_French_Connection	/film/film/production_companies	20th_Century_Fox
Dustin_Hoffman	/base/popstra/celebrity/friendship./base/popstra/friendship/participant	Robert_Duvall
MTV_Video_Music_Award_for_Best_Cinematography	/award/award_category/winners./award/award_honor/award_winner	Jamiroquai
J._Michael_Straczynski	/people/person/profession	journalist
Jamie-Lynn_Sigler	/award/award_winner/awards_won./award/award_honor/award_winner	Dan_Grimaldi
Seattle_SuperSonics	/sports/professional_sports_team/draft_picks./sports/sports_league_draft_pick/draft	2007_NBA_Draft
road_cycling	/olympics/olympic_sport/athletes./olympics/olympic_athlete_affiliation/olympics	1984_Summer_Olympics
Christine_Langan	/award/award_nominee/award_nominations./award/award_nomination/award_nominee	Kathleen_Kennedy
Tel_Aviv_University	/education/educational_institution/school_type	university
Washington_Nationals	/sports/sports_team/roster./baseball/baseball_roster_position/position	left_fielder
Europe	/location/location/contains	Finland
Mike_Nichols	/award/award_nominee/award_nominations./award/award_nomination/award	Academy_Award_for_Best_Picture
Memento	/film/film/release_date_s./film/film_regional_release_date/film_release_region	Canada
Ja_Rule	/film/actor/film./film/performance/film	The_Fast_and_the_Furious
Robert_Plant	/award/award_nominee/award_nominations./award/award_nomination/award	MTV_Video_Music_Award_for_Best_Cinematography
BAFTA_Award_for_Best_Actor_in_a_Supporting_Role	/award/award_category/nominees./award/award_nomination/nominated_for	Cry_Freedom
Signs	/film/film/release_date_s./film/film_regional_release_date/film_release_region	Switzerland
Chris_Cooper	/film/actor/film./film/performance/film	A_Time_to_Kill
Lady_Gaga	/people/person/place_of_birth	New_York_City
Paris,_je_t'aime	/film/film/written_by	/m/02kxbwx
Sicko	/film/film/written_by	Michael_Moore
MTV_Video_Music_Award_for_Best_Cinematography	/award/award_category/winners./award/award_honor/award_winner	The_White_Stripes
52nd_Annual_Grammy_Awards	/award/award_ceremony/awards_presented./award/award_honor/award_winner	Chris_Botti
Ellen_Pompeo	/award/award_winner/awards_won./award/award_honor/award_winner	Chandra_Wilson
Transformers	/film/film/release_date_s./film/film_regional_release_date/film_release_region	Canada
Minnie_Driver	/people/person/profession	singer-songwriter
13_Assassins	/film/film/release_date_s./film/film_regional_release_date/film_release_region	Switzerland
Jamie_Cullum	/music/group_member/membership./music/group_membership/group	Spinal_Tap
Some_Kind_of_Monster	/film/film/release_date_s./film/film_regional_release_date/film_release_region	Augsburg
Julius_J._Epstein	/people/person/place_of_birth	New_York_City
Theodore_Shapiro	/people/person/place_of_birth	Washington,_D.C.
Lili_Taylor	/base/popstra/celebrity/dated./base/popstra/dated/participant	Matthew_Broderick
FC_Bayern_Munich	/sports/sports_team/colors	white
Casper	/film/film/genre	comedy-drama
Cabaret	/film/film/cinematography	Geoffrey_Unsworth
Jewish_people	/people/ethnicity/people	Fred_Ebb
University_of_California,_San_Francisco	/education/educational_institution/school_type	public_university
Knight_and_Day	/film/film/release_date_s./film/film_regional_release_date/film_release_region	Finland
Crash	/award/award_winning_work/awards_won./award/award_honor/award_winner	Larenz_Tate
Joseph_Conrad	/influence/influence_node/influenced_by	H._G._Wells
Amber_Riley	/award/award_nominee/award_nominations./award/award_nomination/award_nominee	Mike_O'Malley
Extremely_Loud_and_Incredibly_Close	/film/film/production_companies	Paramount_Pictures
African_Americans	/people/ethnicity/people	James_Poyser
mayor	/government/government_office_category/officeholders./government/government_position_held/jurisdiction_of_office	El_Paso
Jamie_Cullum	/people/person/profession	singer-songwriter
Solanum_lycopersicum	/food/food/nutrients./food/nutrition_fact/nutrient	L-Serine
Toni_Morrison	/people/person/places_lived./people/place_lived/location	Syracuse
Robert_Fripp	/music/group_member/membership./music/group_membership/role	electric_piano
John_Hurt	/film/actor/film./film/performance/film	The_Proposition
Going_My_Way	/award/award_winning_work/awards_won./award/award_honor/award	Academy_Award_for_Best_Picture
Landon_Donovan	/sports/pro_athlete/teams./sports/sports_team_roster/team	San_Jose_Earthquakes
Cannes_Film_Festival_Award_for_Best_Actor	/award/award_category/winners./award/award_honor/award_winner	Jon_Voight
J-pop	/music/genre/artists	Nana_Mizuki
Johns_Hopkins_University	/education/educational_institution/students_graduates./education/education/student	Woodrow_Wilson
David_Cross	/people/person/places_lived./people/place_lived/location	New_York_City
James_Pickens	/film/actor/film./film/performance/film	Nixon
William_Petersen	/award/award_nominee/award_nominations./award/award_nomination/award_nominee	Paul_Guilfoyle
Degrassi:_The_Next_Generation	/tv/tv_program/genre	teen_drama
Johns_Hopkins_University	/education/educational_institution/colors	Old_gold
In_the_Mood_for_Love	/award/award_winning_work/awards_won./award/award_honor/award	Cannes_Film_Festival_Award_for_Best_Actor
Allen_Iverson	/sports/pro_athlete/teams./sports/sports_team_roster/team	Philadelphia_76ers
2006_NCAA_Men's_Division_I_Basketball_Tournament	/base/marchmadness/ncaa_basketball_tournament/seeds./base/marchmadness/ncaa_tournament_seed/team	LSU_Tigers_basketball
post-punk	/music/genre/parent_genre	funk
Delfino_Pescara_1936	/sports/sports_team/colors	white
French	/media_common/netflix_genre/titles	Paris,_je_t'aime
University_of_Pittsburgh	/education/educational_institution/students_graduates./education/education/major_field_of_study	library_science
Jerry_Bruckheimer	/award/award_nominee/award_nominations./award/award_nomination/award_nominee	Touchstone_Pictures
William_Cameron_Menzies	/award/award_nominee/award_nominations./award/award_nomination/nominated_for	Gone_with_the_Wind
Mandy_Patinkin	/award/award_nominee/award_nominations./award/award_nomination/nominated_for	Homeland
biography	/media_common/netflix_genre/titles	Remember_the_Titans
African_Americans	/people/ethnicity/people	D'Angelo
3_Idiots	/film/film/featured_film_locations	Bangalore
Moby	/award/award_nominee/award_nominations./award/award_nomination/award	MTV_Video_Music_Award_for_Best_Cinematography
aviation	/film/film_subject/films	Rang_De_Basanti
BAFTA_Academy_Fellowship_Award	/award/award_category/winners./award/award_honor/award_winner	David_Lean
Denzel_Washington	/film/actor/film./film/performance/film	Training_Day
Tom_Kenny	/people/person/profession	comedian
Liam_Neeson	/award/award_nominee/award_nominations./award/award_nomination/award_nominee	Shannon_Elizabeth
grindcore	/music/genre/artists	Devin_Townsend
vice_president	/business/job_title/people_with_this_title./business/employment_tenure/company	PepsiCo
Hereafter	/film/film/produced_by	Kathleen_Kennedy
Woodrow_Wilson	/people/person/place_of_birth	Staunton
James_L._Brooks	/award/award_nominee/award_nominations./award/award_nomination/award_nominee	Tracey_Ullman
Cabaret	/award/award_winning_work/awards_won./award/award_honor/award_winner	Ralph_Burns
Jamie_Cullum	/people/person/profession	drummer
Solanum_lycopersicum	/food/food/nutrients./food/nutrition_fact/nutrient	DL-proline
King_Arthur	/film/film/music	Lisa_Gerrard
The_Young_Victoria	/film/film/film_format	35_mm_film
Steve_Earle	/people/person/places_lived./people/place_lived/location	New_York_City
Godzilla	/film/film/genre	action_film
Mike_O'Malley	/award/award_nominee/award_nominations./award/award_nomination/award_nominee	Jenna_Ushkowitz
Lost_Highway	/film/film/release_date_s./film/film_regional_release_date/film_release_region	Finland
Going_My_Way	/film/film/production_companies	Paramount_Pictures
Thunderball	/film/film/genre	action_film
Howl's_Moving_Castle	/film/film/dubbing_performances./film/dubbing_performance/actor	Christian_Bale
Mohnish_Bahl	/award/award_nominee/award_nominations./award/award_nomination/award	Filmfare_Award_for_Best_Supporting_Actor
Christine_Langan	/award/award_nominee/award_nominations./award/award_nomination/award	Academy_Award_for_Best_Picture
Joss_Stone	/people/person/profession	singer-songwriter
Ferris_Bueller's_Day_Off	/film/film/cinematography	Tak_Fujimoto
101st_United_States_Congress	/government/legislative_session/members./government/government_position_held/legislative_sessions	103rd_United_States_Congress
Touchstone_Pictures	/film/film_distributor/films_distributed./film/film_film_distributor_relationship/film	Pretty_Woman
popular_music	/music/genre/artists	Harry_Warren
Chicago_White_Sox	/baseball/baseball_team/team_stats./baseball/baseball_team_stats/season	1965_Major_League_Baseball_season
Chandra_Wilson	/film/actor/film./film/performance/film	Philadelphia
David_Brin	/award/award_nominee/award_nominations./award/award_nomination/award	Nebula_Award_for_Best_Novel
Academy_Award_for_Best_Picture	/award/award_category/nominees./award/award_nomination/nominated_for	Lost_in_Translation
Finland	/olympics/olympic_participating_country/medals_won./olympics/olympic_medal_honor/olympics	1952_Winter_Olympics
free_jazz	/music/genre/artists	Spinal_Tap
H._G._Wells	/people/person/profession	journalist
Billy_Wilder	/award/award_nominee/award_nominations./award/award_nomination/nominated_for	Ninotchka
Constantin_Film	/film/film_distributor/films_distributed./film/film_film_distributor_relationship/film	Downfall
Hot_Fuzz	/film/film/genre	action_film
Carrie	/film/film/release_date_s./film/film_regional_release_date/film_release_region	Finland
Teri_Garr	/film/actor/film./film/performance/film	Searching_for_Debra_Winger
Ernst_Lubitsch	/film/director/film	Ninotchka
Benicio_del_Toro	/award/award_winner/awards_won./award/award_honor/award_winner	Peter_Riegert
Ralph_Stanley	/award/award_nominee/award_nominations./award/award_nomination/award_nominee	Dwight_Yoakam
20th_Century_Fox	/film/film_distributor/films_distributed./film/film_film_distributor_relationship/film	Cabaret
Chris_Botti	/award/award_winner/awards_won./award/award_honor/award_winner	Chris_Thile
Shannon_Elizabeth	/award/award_nominee/award_nominations./award/award_nomination/award_nominee	Sienna_Guillory
broadcasting	/people/profession/specialization_of	communication_medium
Joseph_Heller	/influence/influence_node/influenced_by	Albert_Camus
Grammy_Award_for_Best_Jazz_Instrumental_Album	/award/award_category/winners./award/award_honor/ceremony	52nd_Annual_Grammy_Awards
The_Guns_of_Navarone	/film/film/genre	action_film
Quest_for_Fire	/film/film/country	Canada
prime_minister	/government/government_office_category/officeholders./government/government_position_held/jurisdiction_of_office	Fiji
StudioCanal	/film/film_distributor/films_distributed./film/film_film_distributor_relationship/film	This_Is_Spinal_Tap
Coldplay	/award/award_nominee/award_nominations./award/award_nomination/award	MTV_Video_Music_Award_for_Best_Cinematography
prime_minister	/government/government_office_category/officeholders./government/government_position_held/jurisdiction_of_office	Pakistan
Going_My_Way	/award/award_winning_work/awards_won./award/award_honor/award_winner	Bing_Crosby
Paris,_je_t'aime	/film/film/language	Spanish
BAFTA_Award_for_Best_Animated_Film	/award/award_category/nominees./award/award_nomination/nominated_for	Happy_Feet
Fist_of_the_North_Star	/film/film/genre	action_film
Chris_Thile	/award/award_winner/awards_won./award/award_honor/award_winner	Joshua_Redman
Sony_BMG	/organization/organization/headquarters./location/mailing_address/citytown	New_York_City
Chicago	/location/location/contains	Illinois_Institute_of_Technology
Bollywood	/media_common/netflix_genre/titles	3_Idiots
Happy_Feet	/film/film/other_crew./film/film_crew_gig/film_crew_role	animation_director
Katharine_Hepburn	/award/award_nominee/award_nominations./award/award_nomination/nominated_for	The_Philadelphia_Story
Ang_Lee	/award/award_nominee/award_nominations./award/award_nomination/award	Independent_Spirit_Award_for_Best_Director
Robert_De_Niro	/people/person/places_lived./people/place_lived/location	New_York_City
1941	/film/film/story_by	Robert_Zemeckis
Star_Trek_V:_The_Final_Frontier	/film/film/production_companies	Paramount_Pictures
Katy_Perry	/award/award_nominee/award_nominations./award/award_nomination/award_nominee	Lady_Gaga
Jackass_3D	/film/film/prequel	Jackass_Number_Two
Hank_Williams_Jr.	/people/person/profession	singer-songwriter
Lady_Gaga	/award/award_nominee/award_nominations./award/award_nomination/award_nominee	Katy_Perry
Homeland	/award/award_winning_work/awards_won./award/award_honor/award_winner	Damian_Lewis
European_theatre_of_World_War_I	/base/culturalevent/event/entity_involved	Woodrow_Wilson
99th_United_States_Congress	/government/legislative_session/members./government/government_position_held/legislative_sessions	102nd_United_States_Congress
Bob_Rafelson	/award/award_nominee/award_nominations./award/award_nomination/award	Academy_Award_for_Best_Picture
prime_minister	/government/government_office_category/officeholders./government/government_position_held/jurisdiction_of_office	Uganda
African_Americans	/people/ethnicity/people	Djimon_Hounsou
Ashley_Judd	/award/award_nominee/award_nominations./award/award_nomination/award	National_Society_of_Film_Critics_Award_for_Best_Actress
Knight_and_Day	/film/film/release_date_s./film/film_regional_release_date/film_release_region	Canada
Rice_University	/education/educational_institution/school_type	private_university
Charles_Mingus_Jr.	/music/artist/track_contributions./music/track_contribution/role	double_bass
Bronxville	/location/location/contains	Sarah_Lawrence_College
Jewish_people	/people/ethnicity/people	Mandy_Patinkin
Michael_G._Wilson	/film/actor/film./film/performance/film	The_Spy_Who_Loved_Me
Toni_Braxton	/people/person/profession	singer-songwriter
Senna	/film/film/release_date_s./film/film_regional_release_date/film_release_region	Canada
Malayali	/people/ethnicity/people	Innocent
Christina_Aguilera	/people/person/places_lived./people/place_lived/location	New_York_City
Ernst_Lubitsch	/award/award_nominee/award_nominations./award/award_nomination/award_nominee	Paramount_Pictures
Coming_Home	/award/award_winning_work/awards_won./award/award_honor/award	Cannes_Film_Festival_Award_for_Best_Actor
Burnley	/sports/sports_team_location/teams	Burnley_F.C.
Jewish_people	/people/ethnicity/people	Sienna_Guillory
Niger	/location/country/official_language	French
Albert_S._D'Agostino	/people/person/place_of_birth	New_York_City
Knight_and_Day	/film/film/release_date_s./film/film_regional_release_date/film_release_region	Switzerland
Jon_Voight	/film/actor/film./film/performance/film	Ali
trumpet	/music/performance_role/regular_performances./music/group_membership/group	Jamiroquai
Ferris_Bueller's_Day_Off	/film/film/production_companies	Paramount_Pictures
Love_Actually	/film/film/genre	comedy-drama
Whatcom_County	/location/location/adjoin_s./location/adjoining_relationship/adjoins	Okanogan_County
Tom_Kenny	/people/person/places_lived./people/place_lived/location	Syracuse
Benicio_del_Toro	/award/award_winner/awards_won./award/award_honor/award_winner	James_Brolin
Jim_Cummings	/film/actor/film./film/performance/film	Aladdin
Sienna_Guillory	/award/award_nominee/award_nominations./award/award_nomination/award_nominee	Liam_Neeson
Academy_Award_for_Best_Picture	/award/award_category/winners./award/award_honor/ceremony	57th_Academy_Awards
Pan's_Labyrinth	/film/film/language	Spanish
Ole_Miss_Rebels_football	/sports/sports_team/roster./american_football/football_historical_roster_position/position_s	running_back
prime_minister	/government/government_office_category/officeholders./government/government_position_held/jurisdiction_of_office	Antigua_and_Barbuda
Christian_Bale	/award/award_nominee/award_nominations./award/award_nomination/award	BAFTA_Award_for_Best_Actor_in_a_Supporting_Role
Alison_Krauss	/award/award_nominee/award_nominations./award/award_nomination/award_nominee	Doc_Watson
Virginia_Military_Institute	/education/educational_institution/students_graduates./education/education/student	Fred_Willard
Robert_De_Niro	/award/award_nominee/award_nominations./award/award_nomination/award_nominee	Chris_Tucker
Josh_Lucas	/film/actor/film./film/performance/film	You_Can_Count_on_Me
Secretary_of_State	/government/government_office_category/officeholders./government/government_position_held/jurisdiction_of_office	Louisiana
Katharine_Hepburn	/award/award_nominee/award_nominations./award/award_nomination/award	Tony_Award_for_Best_Actress_in_a_Play
Grammy_Award_for_Best_Female_Pop_Vocal_Performance	/award/award_category/winners./award/award_honor/award_winner	Lady_Gaga
Academy_Award_for_Best_Picture	/award/award_category/nominees./award/award_nomination/nominated_for	Extremely_Loud_and_Incredibly_Close
Academy_Award_for_Best_Picture	/award/award_category/nominees./award/award_nomination/nominated_for	Yankee_Doodle_Dandy
Johns_Hopkins_University	/education/educational_institution/school_type	private_university
Liam_Neeson	/base/popstra/celebrity/dated./base/popstra/dated/participant	Helen_Mirren
Final_Destination_5	/film/film/release_date_s./film/film_regional_release_date/film_release_region	Georgia
National_Society_of_Film_Critics_Award_for_Best_Film	/award/award_category/nominees./award/award_nomination/nominated_for	The_Deer_Hunter
trumpet	/music/instrument/family	brass_instrument
In_the_Mood_for_Love	/film/film/release_date_s./film/film_regional_release_date/film_release_region	Switzerland
Benicio_del_Toro	/award/award_nominee/award_nominations./award/award_nomination/award_nominee	Peter_Riegert
36th_Academy_Awards	/award/award_ceremony/awards_presented./award/award_honor/honored_for	It's_a_Mad,_Mad,_Mad,_Mad_World
89th_United_States_Congress	/government/legislative_session/members./government/government_position_held/legislative_sessions	103rd_United_States_Congress
Bowling_for_Columbine	/award/award_winning_work/awards_won./award/award_honor/award_winner	Michael_Moore
Stellenbosch_University	/education/educational_institution/school_type	public_university
Marcia_Wallace	/people/person/profession	comedian
Butch_Cassidy_and_the_Sundance_Kid	/film/film/language	Spanish
biography	/media_common/netflix_genre/titles	The_Last_Station
The_French_Connection	/award/award_winning_work/awards_won./award/award_honor/award_winner	William_Friedkin
Stephen_King	/influence/influence_node/influenced_by	William_Faulkner
Touchstone_Pictures	/award/award_nominee/award_nominations./award/award_nomination/award_nominee	Jerry_Bruckheimer
BAFTA_Academy_Fellowship_Award	/award/award_category/winners./award/award_honor/award_winner	Billy_Wilder
AOL	/organization/organization/headquarters./location/mailing_address/citytown	New_York_City
Jewish_people	/people/ethnicity/people	Paul_Mazursky
Academy_Award_for_Best_Picture	/award/award_category/nominees./award/award_nomination/nominated_for	Going_My_Way
Robert_De_Niro	/film/actor/film./film/performance/film	The_Untouchables
The_Lord_of_the_Rings:_The_Fellowship_of_the_Ring	/award/award_winning_work/awards_won./award/award_honor/award_winner	Peter_Jackson
Bright_Star	/film/film/executive_produced_by	Christine_Langan
Academy_Award_for_Best_Picture	/award/award_category/winners./award/award_honor/ceremony	36th_Academy_Awards
Amrish_Puri	/award/award_nominee/award_nominations./award/award_nomination/award	Filmfare_Award_for_Best_Supporting_Actor
64th_Primetime_Creative_Arts_Emmy_Awards	/award/award_ceremony/awards_presented./award/award_honor/honored_for	Boardwalk_Empire
Ricky_Gervais	/film/actor/film./film/performance/film	The_Muppets
Ron_Carter	/music/artist/track_contributions./music/track_contribution/role	double_bass
double_bass	/music/performance_role/track_performances./music/track_contribution/role	alto_saxophone
Allen_Ginsberg	/influence/influence_node/influenced_by	Franz_Kafka
North_Korea	/olympics/olympic_participating_country/medals_won./olympics/olympic_medal_honor/olympics	1976_Summer_Olympics
Filipino_American	/people/ethnicity/languages_spoken	Spanish
electric_piano	/music/performance_role/track_performances./music/track_contribution/role	Vocoder
Patricia_Heaton	/award/award_nominee/award_nominations./award/award_nomination/award_nominee	Doris_Roberts
Craig_Robinson	/people/person/place_of_birth	Chicago
Grammy_Award_for_Best_Jazz_Instrumental_Album	/award/award_category/winners./award/award_honor/award_winner	Ron_Carter
The_Witches_of_Eastwick	/film/film/cinematography	Vilmos_Zsigmond
Paul_Giamatti	/film/actor/film./film/performance/film	Sideways
Chris_Cooper	/award/award_nominee/award_nominations./award/award_nomination/award	BAFTA_Award_for_Best_Actor_in_a_Supporting_Role
Yo-Yo_Ma	/award/award_winner/awards_won./award/award_honor/award_winner	Alison_Krauss
Forrest_Gump	/film/film/featured_film_locations	Washington,_D.C.
Smokin'_Aces	/film/film/genre	action_film
electric_piano	/music/performance_role/regular_performances./music/group_membership/role	trumpet
Adam_Sandler	/award/award_nominee/award_nominations./award/award_nomination/award_nominee	Kevin_James
Rensselaer_County	/location/location/adjoin_s./location/adjoining_relationship/adjoins	Greene_County
Canada	/location/location/contains	Brampton
Gramercy_Pictures	/film/film_distributor/films_distributed./film/film_film_distributor_relationship/film	Dead_Man_Walking
Manoj_Kumar	/award/award_nominee/award_nominations./award/award_nomination/award	Filmfare_Award_for_Best_Supporting_Actor
Gus_Van_Sant	/award/award_nominee/award_nominations./award/award_nomination/award	Independent_Spirit_Award_for_Best_Director
Creed_Bratton	/award/award_nominee/award_nominations./award/award_nomination/award_nominee	Angela_Kinsey
Allen_Ginsberg	/people/person/places_lived./people/place_lived/location	New_York_City
Gina_Gershon	/film/actor/film./film/performance/film	The_Insider
Academy_Award_for_Best_Picture	/award/award_category/nominees./award/award_nomination/nominated_for	Jaws
death_metal	/music/genre/parent_genre	thrash_metal
The_Island_Def_Jam_Music_Group	/organization/organization/headquarters./location/mailing_address/citytown	New_York_City
Bernadette_Peters	/film/actor/film./film/performance/film	Anastasia
Ernst_Lubitsch	/award/award_winner/awards_won./award/award_honor/award_winner	Paramount_Pictures
Guildhall_School_of_Music_and_Drama	/education/educational_institution/students_graduates./education/education/student	Dido
Love_Is_a_Many-Splendored_Thing	/film/film/music	Alfred_Newman
Latin_Grammy_Award_for_Album_of_the_Year	/award/award_category/winners./award/award_honor/award_winner	Shakira
aviation	/film/film_subject/films	Chicken_Run
Edward_R._Pressman	/people/person/place_of_birth	New_York_City
Chris_Cooper	/film/actor/film./film/performance/film	Adaptation
judo	/olympics/olympic_sport/athletes./olympics/olympic_athlete_affiliation/country	Niger
Elite_Squad:_The_Enemy_Within	/film/film/release_date_s./film/film_regional_release_date/film_release_region	Finland
1997_Grammy_Awards	/award/award_ceremony/awards_presented./award/award_honor/award_winner	The_Beatles
Academy_Award_for_Best_Picture	/award/award_category/nominees./award/award_nomination/nominated_for	The_Philadelphia_Story
contemporary_R&B	/music/genre/artists	Adam_Levine
Xavier_University	/education/educational_institution/colors	white
Michael_Tollin	/award/award_nominee/award_nominations./award/award_nomination/nominated_for	Norbit
Lars_Hirschfeld	/people/person/nationality	Canada
Paramount_Pictures	/award/award_nominee/award_nominations./award/award_nomination/award_nominee	20th_Century_Fox
Priest	/film/film/music	Lisa_Gerrard
Paul_Reubens	/award/award_winner/awards_won./award/award_honor/award_winner	Al_Franken
Ferris_Bueller's_Day_Off	/film/film/featured_film_locations	Woodland_Hills
Michael_G._Wilson	/people/person/place_of_birth	New_York_City
Coming_Home	/film/film/cinematography	Haskell_Wexler
vibraphone	/music/performance_role/regular_performances./music/group_membership/role	electric_piano
Adam_Sandler	/film/actor/film./film/performance/film	Grown_Ups
Prometheus_Award	/award/award_category/winners./award/award_honor/award_winner	J._R._R._Tolkien
Catherine_O'Hara	/people/person/profession	comedian
James_Cayne	/organization/organization/headquarters./location/mailing_address/citytown	New_York_City
Jon_Brion	/music/artist/track_contributions./music/track_contribution/role	vibraphone
Claudette_Colbert	/base/popstra/celebrity/dated./base/popstra/dated/participant	Marlene_Dietrich
prime_minister	/government/government_office_category/officeholders./government/government_position_held/jurisdiction_of_office	Benin
J._J._Abrams	/award/award_winner/awards_won./award/award_honor/award_winner	Edward_Kitsis
8_Mile	/film/film/production_companies	Imagine_Entertainment
Adam_Sandler	/award/award_nominee/award_nominations./award/award_nomination/nominated_for	Grown_Ups
Yo-Yo_Ma	/award/award_nominee/award_nominations./award/award_nomination/award_nominee	Chris_Botti
DreamWorks_Records	/music/record_label/artist	The_Isley_Brothers
president	/business/job_title/people_with_this_title./business/employment_tenure/company	Rice_University
Paramount_Pictures	/award/award_nominee/award_nominations./award/award_nomination/award_nominee	Kathleen_Kennedy
contemporary_R&B	/music/genre/artists	Lady_Gaga
Chris_Thile	/award/award_nominee/award_nominations./award/award_nomination/award_nominee	Chris_Botti
Mike_Nichols	/people/person/profession	comedian
Cry_Freedom	/film/film/film_production_design_by	Stuart_Craig
Kristin_Scott_Thomas	/award/award_nominee/award_nominations./award/award_nomination/award_nominee	Charles_Dance
Bill_Pullman	/film/actor/film./film/performance/film	Casper
BAFTA_Academy_Fellowship_Award	/award/award_category/winners./award/award_honor/award_winner	Steven_Bochco
Kristin_Scott_Thomas	/film/actor/film./film/performance/film	The_Other_Boleyn_Girl
Arista_Records	/music/record_label/artist	Dido
John_Lee_Hooker	/people/person/profession	singer-songwriter
Spirited_Away	/film/film/release_date_s./film/film_regional_release_date/film_release_region	Switzerland
Jeffrey_Wright	/people/person/place_of_birth	Washington,_D.C.
Josh_Freese	/people/person/profession	drummer
Jewish_people	/people/ethnicity/people	Adam_Levine
13_Assassins	/film/film/release_date_s./film/film_regional_release_date/film_release_region	Finland
Lost_in_Translation	/award/award_winning_work/awards_won./award/award_honor/award	Independent_Spirit_Award_for_Best_Director
Ticino	/location/administrative_division/first_level_division_of	Switzerland
Oregon_State_Beavers_football	/sports/sports_team/roster./american_football/football_historical_roster_position/position_s	running_back
National_Society_of_Film_Critics_Award_for_Best_Film	/award/award_category/nominees./award/award_nomination/nominated_for	Happy-Go-Lucky
20th_Century_Fox	/award/award_nominee/award_nominations./award/award_nomination/award_nominee	Paramount_Pictures
Chris_Cooper	/film/actor/film./film/performance/film	The_Bourne_Supremacy
Godzilla	/film/film/language	French
electric_piano	/music/performance_role/regular_performances./music/group_membership/role	baritone_guitar
Benicio_del_Toro	/award/award_nominee/award_nominations./award/award_nomination/award_nominee	James_Brolin
Alison_Krauss	/award/award_nominee/award_nominations./award/award_nomination/award_nominee	Yo-Yo_Ma
Jamie_Gangel	/people/person/places_lived./people/place_lived/location	New_York_City
Solanum_lycopersicum	/food/food/nutrients./food/nutrition_fact/nutrient	protein
Chicago	/location/location/adjoin_s./location/adjoining_relationship/adjoins	Evanston
David_Banner	/award/award_nominee/award_nominations./award/award_nomination/award_nominee	Busta_Rhymes
National_Taiwan_University	/education/educational_institution/school_type	public_university
Chris_Thile	/award/award_winner/awards_won./award/award_honor/award_winner	Chris_Botti
13_Assassins	/film/film/film_festivals	2010_Toronto_International_Film_Festival
21_Grams	/award/award_winning_work/awards_won./award/award_honor/award_winner	Benicio_del_Toro
L.A._Law	/award/award_winning_work/awards_won./award/award_honor/award_winner	Steven_Bochco
Germany_national_football_team	/base/x2010fifaworldcupsouthafrica/world_cup_squad/current_world_cup_squad./base/x2010fifaworldcupsouthafrica/current_world_cup_squad/current_club	FC_Bayern_Munich
20th_Century_Fox	/award/award_nominee/award_nominations./award/award_nomination/award_nominee	Dean_Devlin
Peter_Fonda	/award/award_nominee/award_nominations./award/award_nomination/award_nominee	Christian_Bale
prime_minister	/government/government_office_category/officeholders./government/government_position_held/jurisdiction_of_office	Georgia
president	/government/government_office_category/officeholders./government/government_position_held/jurisdiction_of_office	Porto
20th_Century_Fox	/film/film_distributor/films_distributed./film/film_film_distributor_relationship/film	Anastasia
University_of_California,_Los_Angeles	/education/educational_institution/students_graduates./education/education/major_field_of_study	education
Get_Carter	/film/film/genre	action_film
Federico_Fellini	/award/award_nominee/award_nominations./award/award_nomination/award	BAFTA_Academy_Fellowship_Award
road_cycling	/olympics/olympic_sport/athletes./olympics/olympic_athlete_affiliation/country	Georgia
Spanish	/language/human_language/countries_spoken_in	Honduras
Carmen_Electra	/base/popstra/celebrity/friendship./base/popstra/friendship/participant	Kelly_Osbourne
Grammy_Award_for_Best_Latin_Pop_Album	/award/award_category/winners./award/award_honor/ceremony	1997_Grammy_Awards
Yo-Yo_Ma	/award/award_nominee/award_nominations./award/award_nomination/award_nominee	Joshua_Redman
Glens_Falls	/location/hud_county_place/county	Warren_County
Yoram_Globus	/award/award_nominee/award_nominations./award/award_nomination/nominated_for	Tough_Guys_Don't_Dance
Washington_Nationals	/sports/sports_team/colors	white
Mobile_Suit_Gundam:_Char's_Counterattack	/film/film/genre	action_film
Ferris_Bueller's_Day_Off	/film/film/genre	cult_film
Devin_Townsend	/people/person/profession	singer-songwriter
funk	/music/genre/artists	Buckethead
Kate_Walsh	/base/popstra/celebrity/friendship./base/popstra/friendship/participant	Chandra_Wilson
Marisa_Tomei	/award/award_winner/awards_won./award/award_honor/award_winner	Ethan_Hawke
The_Adventures_of_Priscilla,_Queen_of_the_Desert	/film/film/genre	road_movie
Lili_Taylor	/award/award_winner/awards_won./award/award_honor/award_winner	Frances_Conroy
Anne_Rice	/influence/influence_node/influenced_by	Albert_Camus
Simon_Fuller	/people/person/profession	talent_manager
The_Green_Mile	/film/film/music	Thomas_Newman
Love_Is_a_Many-Splendored_Thing	/film/film/genre	biography
Kate_Walsh	/award/award_nominee/award_nominations./award/award_nomination/award_nominee	Chandra_Wilson
judo	/olympics/olympic_sport/athletes./olympics/olympic_athlete_affiliation/country	Finland
Patrick_Gallagher	/award/award_winner/awards_won./award/award_honor/award_winner	Josh_Sussman
Toy_Story_2	/film/film/other_crew./film/film_crew_gig/crewmember	Gary_Rydstrom
vibraphone	/music/performance_role/track_performances./music/track_contribution/role	viola
Margaret_Thatcher	/government/politician/government_positions_held./government/government_position_held/basic_title	prime_minister
African_Americans	/people/ethnicity/people	Lenny_Kravitz
Jason_Sudeikis	/people/person/profession	comedian
Helen_Mirren	/award/award_nominee/award_nominations./award/award_nomination/award_nominee	Kristin_Scott_Thomas
Palm_Beach_County	/location/location/adjoin_s./location/adjoining_relationship/adjoins	Broward_County
BAFTA_Award_for_Best_Actor_in_a_Supporting_Role	/award/award_category/winners./award/award_honor/award_winner	John_Hurt
In_the_Mood_for_Love	/film/film/written_by	Wong_Kar-wai
Happy-Go-Lucky	/film/film/genre	comedy-drama
Saxony	/location/location/contains	Leipzig
Olivia_de_Havilland	/base/popstra/celebrity/dated./base/popstra/dated/participant	James_Stewart
Jewish_people	/people/ethnicity/people	Jerry_Bruckheimer
defenceman	/sports/sports_position/players./sports/sports_team_roster/team	Chicago_Blackhawks
Lady_Gaga	/award/award_nominee/award_nominations./award/award_nomination/award	Grammy_Award_for_Best_Female_Pop_Vocal_Performance
Kate_Walsh	/award/award_winner/awards_won./award/award_honor/award_winner	James_Pickens
Murphy_Brown	/award/award_winning_work/awards_won./award/award_honor/award_winner	Colleen_Dewhurst
Don_Henley	/music/group_member/membership./music/group_membership/group	Eagles
Tsinghua_University	/education/educational_institution/school_type	public_university
Senna	/film/film/production_companies	StudioCanal
Canada	/olympics/olympic_participating_country/medals_won./olympics/olympic_medal_honor/olympics	1952_Winter_Olympics
The_Gathering_Storm	/award/award_winning_work/awards_won./award/award_honor/award	Primetime_Emmy_Award_for_Outstanding_Writing_for_a_Miniseries,_Movie_or_a_Dramatic_Special
Chiwetel_Ejiofor	/award/award_nominee/award_nominations./award/award_nomination/award_nominee	Sienna_Guillory
Macquarie_University	/education/educational_institution/colors	white
drone_music	/music/genre/artists	Steven_Wilson
president	/government/government_office_category/officeholders./government/government_position_held/jurisdiction_of_office	Malta
pneumonia	/people/cause_of_death/people	Steve_Gerber
Roy_Webb	/people/person/places_lived./people/place_lived/location	New_York_City
Naked_Lunch	/film/film/film_format	35_mm_film
David_Letterman	/people/person/profession	comedian
judo	/olympics/olympic_sport/athletes./olympics/olympic_athlete_affiliation/country	Georgia
Kate_Walsh	/award/award_winner/awards_won./award/award_honor/award_winner	Ellen_Pompeo
Saul_Bellow	/influence/influence_node/influenced_by	Marcel_Proust
Paramount_Pictures	/film/film_distributor/films_distributed./film/film_film_distributor_relationship/film	Forrest_Gump
Paul_Auster	/influence/influence_node/influenced_by	Albert_Camus
Nina_Simone	/influence/influence_node/peers./influence/peer_relationship/peers	James_Baldwin
The_Fisher_King	/film/film/genre	comedy-drama
double_bass	/music/instrument/instrumentalists	Hank_Williams_Jr.
Jamiroquai	/award/award_nominee/award_nominations./award/award_nomination/award	MTV_Video_Music_Award_for_Best_Cinematography
Guy_Pearce	/award/award_winner/awards_won./award/award_honor/award_winner	Helena_Bonham_Carter
Bright_Star	/film/film/film_format	35_mm_film
20th_Century_Fox	/film/film_distributor/films_distributed./film/film_film_distributor_relationship/film	Unstoppable
Academy_Award_for_Best_Picture	/award/award_category/nominees./award/award_nomination/nominated_for	Anne_of_the_Thousand_Days
51st_Academy_Awards	/award/award_ceremony/awards_presented./award/award_honor/award_winner	Jon_Voight
Sam_Waterston	/award/award_nominee/award_nominations./award/award_nomination/award_nominee	Jerry_Orbach
Teri_Garr	/base/popstra/celebrity/dated./base/popstra/dated/participant	David_Letterman
Love_Is_a_Many-Splendored_Thing	/award/award_winning_work/awards_won./award/award_honor/award_winner	Alfred_Newman
Ted_Field	/people/person/place_of_birth	Chicago
Jewish_people	/people/ethnicity/people	Daniel_Radcliffe
Sideways	/film/film/film_format	35_mm_film
Jewish_people	/people/ethnicity/people	Franz_Kafka
Matthew_Broderick	/film/actor/film./film/performance/film	New_Year's_Eve
Kathleen_Kennedy	/award/award_nominee/award_nominations./award/award_nomination/award_nominee	Peter_Jackson
Cabaret	/film/film/music	Fred_Ebb
Alison_Krauss	/award/award_winner/awards_won./award/award_honor/award_winner	Randy_Travis
Sarah_Lawrence_College	/education/educational_institution/colors	white
Doctor_of_Medicine	/education/educational_degree/people_with_this_degree./education/education/institution	University_of_Ghana
Hong_Kong_Film_Award_for_Best_New_Performer	/award/award_category/nominees./award/award_nomination/nominated_for	Bodyguards_and_Assassins
pop_punk	/music/genre/artists	The_Offspring
Feroz_Khan	/award/award_nominee/award_nominations./award/award_nomination/award	Filmfare_Award_for_Best_Supporting_Actor
University_of_Central_Florida	/education/educational_institution/colors	Old_gold
Joshua_Redman	/people/person/places_lived./people/place_lived/location	Berkeley
Celebrity	/film/film/featured_film_locations	New_York_City
The_O.C.	/tv/tv_program/genre	teen_drama
EMI_Records	/music/record_label/artist	Nickelback
president	/government/government_office_category/officeholders./government/government_position_held/jurisdiction_of_office	Finland
Ticino	/location/administrative_division/country	Switzerland
Sofia_Coppola	/people/person/place_of_birth	New_York_City
African_Americans	/people/ethnicity/people	Anthony_Mackie
Golden_Satellite_Awards_2004	/award/award_ceremony/awards_presented./award/award_honor/award_winner	Annette_Bening
president	/business/job_title/people_with_this_title./business/employment_tenure/company	Vassar_College
Piranha_3D	/film/film/genre	cult_film
Filmfare_Award_for_Best_Supporting_Actor	/award/award_category/nominees./award/award_nomination/nominated_for	Rang_De_Basanti
Manobala	/people/person/profession	comedian
Sony_Pictures_Home_Entertainment	/film/film_distributor/films_distributed./film/film_film_distributor_relationship/film	Willow
African_Americans	/people/ethnicity/people	Nina_Simone
Josh_Sussman	/award/award_nominee/award_nominations./award/award_nomination/award_nominee	Patrick_Gallagher
Jeffrey_Wright	/film/actor/film./film/performance/film	Extremely_Loud_and_Incredibly_Close
Damian_Lewis	/award/award_nominee/award_nominations./award/award_nomination/award_nominee	Mandy_Patinkin
She_Hate_Me	/film/film/language	Spanish
Peter_Jackson	/award/award_winner/awards_won./award/award_honor/award_winner	Kathleen_Kennedy
Mark_Williams	/people/person/profession	comedian
James_Brolin	/award/award_nominee/award_nominations./award/award_nomination/award_nominee	Benicio_del_Toro
Anne_of_the_Thousand_Days	/film/film/release_date_s./film/film_regional_release_date/film_release_region	Finland
Peter_Jackson	/award/award_nominee/award_nominations./award/award_nomination/nominated_for	The_Lord_of_the_Rings:_The_Fellowship_of_the_Ring
post-punk	/music/genre/artists	Depeche_Mode
Doctor_of_Medicine	/education/educational_degree/people_with_this_degree./education/education/institution	Yale_School_of_Medicine
Grover_Cleveland	/government/politician/government_positions_held./government/government_position_held/basic_title	president
Sofia_Coppola	/award/award_nominee/award_nominations./award/award_nomination/award	Academy_Award_for_Best_Picture
Glenn_Frey	/award/award_nominee/award_nominations./award/award_nomination/award_nominee	Don_Henley
Wong_Kar-wai	/film/director/film	In_the_Mood_for_Love
baritone_guitar	/music/performance_role/track_performances./music/track_contribution/role	twelve-string_guitar
Albert_Camus	/influence/influence_node/influenced_by	Franz_Kafka
progressive_bluegrass	/music/genre/artists	Chris_Thile
On_Her_Majesty's_Secret_Service	/award/award_nominated_work/award_nominations./award/award_nomination/nominated_for	Thunderball
EMI_Records	/music/record_label/artist	Sheena_Easton
MTV_Movie_Award_for_Best_New_Filmmaker	/award/award_category/nominees./award/award_nomination/nominated_for	Memento
Doctor_of_Medicine	/education/educational_degree/people_with_this_degree./education/education/institution	Hebrew_University_of_Jerusalem
Coconino_County	/location/us_county/county_seat	Flagstaff
pop_punk	/music/genre/artists	Ramones
Academy_Award_for_Best_Picture	/award/award_category/nominees./award/award_nomination/nominated_for	The_Artist
20th_Century_Fox	/award/award_winner/awards_won./award/award_honor/award_winner	Paramount_Pictures
Paramount_Pictures	/film/film_distributor/films_distributed./film/film_film_distributor_relationship/film	Star_Trek_V:_The_Final_Frontier
Newcastle_University	/education/educational_institution/colors	Old_gold
Gene_Roddenberry	/people/person/place_of_birth	El_Paso
Sioux	/people/ethnicity/languages_spoken	French
Newcastle_University	/organization/organization/headquarters./location/mailing_address/citytown	Newcastle_upon_Tyne
Pretty_Woman	/film/film/production_companies	Silver_Screen_Partners
57th_Academy_Awards	/award/award_ceremony/awards_presented./award/award_honor/award_winner	Patrizia_von_Brandenstein
Palm_Beach_County	/location/location/contains	Pompano_Beach
trumpet	/music/performance_role/regular_performances./music/group_membership/role	alto_saxophone
DreamWorks_Records	/music/record_label/artist	Randy_Travis
Paramount_Pictures	/film/film_distributor/films_distributed./film/film_film_distributor_relationship/film	Transformers
Shirley_Temple	/people/person/places_lived./people/place_lived/location	Washington,_D.C.
Lenny_Kravitz	/people/person/profession	singer-songwriter
Final_Destination_5	/film/film/release_date_s./film/film_regional_release_date/film_release_region	Canada
Paul_Walker	/base/popstra/celebrity/friendship./base/popstra/friendship/participant	Tyrese_Gibson
Signs	/film/film/cinematography	Tak_Fujimoto
Sarah_Lawrence_College	/education/educational_institution/students_graduates./education/education/student	Julianna_Margulies
Six_Feet_Under	/tv/tv_program/regular_cast./tv/regular_tv_appearance/actor	Lili_Taylor
Alison_Krauss	/award/award_nominee/award_nominations./award/award_nomination/award_nominee	Nitty_Gritty_Dirt_Band
Alison_Krauss	/award/award_nominee/award_nominations./award/award_nomination/award_nominee	Randy_Travis
Screen_Actors_Guild_Award_for_Outstanding_Performance_by_a_Female_Actor_in_a_Drama_Series	/award/award_category/nominees./award/award_nomination/nominated_for	Six_Feet_Under
Doctor_of_Medicine	/education/educational_degree/people_with_this_degree./education/education/institution	University_of_California,_San_Francisco
Ugly_Betty	/tv/tv_program/genre	comedy-drama
Signs	/film/film/release_date_s./film/film_regional_release_date/film_release_region	Finland
Solanum_lycopersicum	/food/food/nutrients./food/nutrition_fact/nutrient	Monounsaturated_fat
Chris_Thile	/people/person/profession	singer-songwriter
Kuk_Harrell	/award/award_nominee/award_nominations./award/award_nomination/award_nominee	Katy_Perry
running_back	/sports/sports_position/players./sports/sports_team_roster/team	Buffalo_Bills
Denzel_Washington	/film/actor/film./film/performance/film	The_Manchurian_Candidate
Madagascar	/film/film/language	Spanish
Guy_Pearce	/award/award_nominee/award_nominations./award/award_nomination/award_nominee	Helena_Bonham_Carter
Denzel_Washington	/award/award_nominee/award_nominations./award/award_nomination/nominated_for	Remember_the_Titans
Terry_Crews	/film/actor/film./film/performance/film	Norbit
Touchstone_Pictures	/film/film_distributor/films_distributed./film/film_film_distributor_relationship/film	Calendar_Girls
Transformers	/film/film/genre	action_film
MTV_Video_Music_Award_for_Best_Cinematography	/award/award_category/winners./award/award_honor/award_winner	Moby
Monster	/film/film/music	BT
Martine_McCutcheon	/award/award_nominee/award_nominations./award/award_nomination/award_nominee	Shannon_Elizabeth
Chris_Botti	/award/award_winner/awards_won./award/award_honor/award_winner	Joshua_Redman
University_of_Ghana	/education/educational_institution/school_type	public_university
Cry_Freedom	/film/film/genre	biography
Goya_Award_for_Best_Film	/award/award_category/nominees./award/award_nomination/nominated_for	Pan's_Labyrinth
The_Green_Mile	/film/film/language	French
mayor	/government/government_office_category/officeholders./government/government_position_held/jurisdiction_of_office	Lafayette
African_Americans	/people/ethnicity/people	Chandra_Wilson
Madagascar	/film/film/genre	computer_animation
Dirty_Dancing	/film/film/film_format	35_mm_film
biography	/media_common/netflix_genre/titles	Cry_Freedom
Canada	/olympics/olympic_participating_country/medals_won./olympics/olympic_medal_honor/olympics	1964_Summer_Olympics
Finding_Neverland	/film/film/genre	biography
Rushmore	/film/film/release_date_s./film/film_regional_release_date/film_release_region	Finland
Naked_Lunch	/film/film/country	Canada
Kevin_James	/film/actor/film./film/performance/film	Grown_Ups
Canada	/location/location/contains	Kamloops
Roger_Federer	/people/person/nationality	Switzerland
Kirk_Franklin	/people/person/profession	music_director
Steve_Earle	/people/person/profession	singer-songwriter
Finland	/olympics/olympic_participating_country/medals_won./olympics/olympic_medal_honor/olympics	1984_Summer_Olympics
Helen_Mirren	/film/actor/film./film/performance/film	The_Prince_of_Egypt
Naked_Lunch	/award/award_winning_work/awards_won./award/award_honor/award	Genie_Award_for_Best_Achievement_in_Art_Direction/Production_Design
Primetime_Emmy_Award_for_Outstanding_Writing_for_a_Miniseries,_Movie_or_a_Dramatic_Special	/award/award_category/nominees./award/award_nomination/nominated_for	The_Gathering_Storm
Paramount_Pictures	/award/award_winner/awards_won./award/award_honor/award_winner	Ernst_Lubitsch
Angela_Kinsey	/award/award_nominee/award_nominations./award/award_nomination/award_nominee	Creed_Bratton
In_the_Mood_for_Love	/film/film/film_format	35_mm_film
Irving_Thalberg	/award/award_nominee/award_nominations./award/award_nomination/award	Academy_Award_for_Best_Picture
Memento	/film/film/release_date_s./film/film_regional_release_date/film_release_region	Switzerland
Trinity_University	/education/educational_institution/school_type	university
1976_Summer_Olympics	/user/jg/default_domain/olympic_games/sports	road_cycling
Alison_Krauss	/award/award_winner/awards_won./award/award_honor/award_winner	Yo-Yo_Ma
Jason_Flemyng	/film/actor/film./film/performance/film	Clash_of_the_Titans
Denzel_Washington	/base/popstra/celebrity/friendship./base/popstra/friendship/participant	Lenny_Kravitz
Landon_Donovan	/sports/pro_athlete/teams./sports/sports_team_roster/team	FC_Bayern_Munich
Thoroughly_Modern_Millie	/film/film/featured_film_locations	New_York_City
Collingwood_Football_Club	/sports/sports_team/colors	white
biography	/media_common/netflix_genre/titles	Tucker:_The_Man_and_His_Dream
African_Americans	/people/ethnicity/people	Loretta_Devine
Trinity_University	/education/educational_institution/school_type	private_university
running_back	/sports/sports_position/players./sports/sports_team_roster/team	Oregon_Ducks_football
Love_Actually	/award/award_winning_work/awards_won./award/award_honor/award	BAFTA_Award_for_Best_Actor_in_a_Supporting_Role
51st_Academy_Awards	/award/award_ceremony/awards_presented./award/award_honor/honored_for	Coming_Home
Angela_Kinsey	/people/person/places_lived./people/place_lived/location	Lafayette
Carrie	/award/award_winning_work/awards_won./award/award_honor/award	National_Society_of_Film_Critics_Award_for_Best_Actress
Rod_Serling	/influence/influence_node/influenced_by	H._P._Lovecraft
Kirsten_Dunst	/award/award_nominee/award_nominations./award/award_nomination/award	National_Society_of_Film_Critics_Award_for_Best_Actress
Oklahoma_State_Cowboys_football	/sports/sports_team/roster./american_football/football_historical_roster_position/position_s	running_back
Michael_Curtiz	/award/award_nominee/award_nominations./award/award_nomination/nominated_for	Yankee_Doodle_Dandy
Jewish_people	/people/ethnicity/people	Michael_Curtiz
EMI_Records	/music/record_label/artist	Freddie_Mercury
vibraphone	/music/performance_role/track_performances./music/track_contribution/role	electric_piano
Kevin_James	/award/award_nominee/award_nominations./award/award_nomination/award_nominee	Adam_Sandler
Kristin_Scott_Thomas	/film/actor/film./film/performance/film	Four_Weddings_and_a_Funeral
Peter_Jackson	/award/award_nominee/award_nominations./award/award_nomination/award	Academy_Award_for_Best_Picture
Ricky_Gervais	/award/award_nominee/award_nominations./award/award_nomination/award	Primetime_Emmy_Award_for_Outstanding_Writing_for_a_Miniseries,_Movie_or_a_Dramatic_Special
post-punk	/music/genre/artists	Josh_Freese
Robert_Zemeckis	/award/award_nominee/award_nominations./award/award_nomination/nominated_for	Forrest_Gump
John_Hurt	/film/actor/film./film/performance/film	Recount
funk	/music/genre/artists	Joss_Stone
Fred_Willard	/award/award_nominee/award_nominations./award/award_nomination/award_nominee	Catherine_O'Hara
Mortal_Kombat:_Annihilation	/film/film/music	George_S._Clinton
51st_Academy_Awards	/award/award_ceremony/awards_presented./award/award_honor/honored_for	Death_on_the_Nile
Senna	/film/film/language	French
Paris,_je_t'aime	/film/film/country	Switzerland
DeWitt_Clinton	/government/politician/government_positions_held./government/government_position_held/basic_title	mayor
alternative_country	/music/genre/artists	Steve_Earle
Nokia	/base/schemastaging/organization_extra/phone_number./base/schemastaging/phone_sandbox/service_location	Finland
Mary-Louise_Parker	/award/award_nominee/award_nominations./award/award_nomination/award	Tony_Award_for_Best_Actress_in_a_Play
Arista_Records	/music/record_label/artist	Toni_Braxton
Parlophone	/music/record_label/artist	Freddie_Mercury
Matt_Selman	/award/award_nominee/award_nominations./award/award_nomination/award_nominee	John_Frink
Northern_Illinois_University	/education/educational_institution/students_graduates./education/education/student	Robert_Zemeckis
Jewish_people	/people/ethnicity/people	Joseph_Heller
vibraphone	/music/performance_role/track_performances./music/track_contribution/role	double_bass
1968_Winter_Olympics	/user/jg/default_domain/olympic_games/sports	biathlon
Thoroughly_Modern_Millie	/film/film/language	French
Alison_Krauss	/award/award_nominee/award_nominations./award/award_nomination/award_nominee	Robert_Plant
Deep_Impact	/film/film/genre	action_film
Primetime_Emmy_Award_for_Outstanding_Writing_for_a_Miniseries,_Movie_or_a_Dramatic_Special	/award/award_category/nominees./award/award_nomination/nominated_for	Bleak_House
Tucker:_The_Man_and_His_Dream	/film/film/genre	biography
Charles_Dance	/film/actor/film./film/performance/film	Hilary_and_Jackie
Clemson_University	/education/educational_institution/school_type	public_university
The_Lord_of_the_Rings:_The_Fellowship_of_the_Ring	/film/film/release_date_s./film/film_regional_release_date/film_release_region	Canada
Turku	/base/biblioness/bibs_location/country	Finland
Ron_Carter	/music/group_member/membership./music/group_membership/role	double_bass
Bob_Rafelson	/people/person/places_lived./people/place_lived/location	New_York_City
Primetime_Emmy_Award_for_Outstanding_Main_Title_Theme_Music	/award/award_category/category_of	Primetime_Emmy_Award
Jewish_people	/people/ethnicity/people	Matthew_Broderick
president	/government/government_office_category/officeholders./government/government_position_held/jurisdiction_of_office	Honduras
Dustin_Hoffman	/film/actor/film./film/performance/film	Finding_Neverland
The_Beatles	/base/popstra/celebrity/friendship./base/popstra/friendship/participant	Peter_Sellers
Independent_Spirit_Award_for_Best_Director	/award/award_category/nominees./award/award_nomination/nominated_for	The_Savages
James_Brolin	/award/award_winner/awards_won./award/award_honor/award_winner	Benicio_del_Toro
African_Americans	/people/ethnicity/people	Larenz_Tate
Southern_hip_hop	/music/genre/artists	David_Banner
Amber_Riley	/award/award_winner/awards_won./award/award_honor/award_winner	Jenna_Ushkowitz
DreamWorks_Records	/music/record_label/artist	Elliott_Smith
Groucho_Marx	/people/person/places_lived./people/place_lived/location	New_York_City
Southern_University	/education/educational_institution/school_type	public_university
The_Artist	/film/film/release_date_s./film/film_regional_release_date/film_release_region	Finland
Chiwetel_Ejiofor	/film/actor/film./film/performance/film	She_Hate_Me
Heavy_Metal	/film/film/genre	cult_film
1984_Summer_Olympics	/user/jg/default_domain/olympic_games/sports	road_cycling
Doris_Roberts	/award/award_winner/awards_won./award/award_honor/award_winner	Patricia_Heaton
Kansas_City_Royals	/sports/sports_team/roster./baseball/baseball_roster_position/position	left_fielder
Stephen_King	/influence/influence_node/influenced_by	H._P._Lovecraft
National_Society_of_Film_Critics_Award_for_Best_Film	/award/award_category/nominees./award/award_nomination/nominated_for	A_History_of_Violence
Elite_Squad:_The_Enemy_Within	/film/film/release_date_s./film/film_regional_release_date/film_regional_debut_venue	New_York_City
20th_Century_Fox	/film/film_distributor/films_distributed./film/film_film_distributor_relationship/film	The_French_Connection
biography	/media_common/netflix_genre/titles	Hilary_and_Jackie
Thunderball	/award/award_nominated_work/award_nominations./award/award_nomination/nominated_for	On_Her_Majesty's_Secret_Service
Shannon_Elizabeth	/award/award_nominee/award_nominations./award/award_nomination/award_nominee	Martine_McCutcheon
Swaziland	/location/country/form_of_government	parliamentary_system
Tom_Fontana	/award/award_nominee/award_nominations./award/award_nomination/award	Primetime_Emmy_Award_for_Outstanding_Writing_for_a_Miniseries,_Movie_or_a_Dramatic_Special
Tobey_Maguire	/base/popstra/celebrity/dated./base/popstra/dated/participant	Christina_Aguilera
1976_Summer_Olympics	/olympics/olympic_games/sports	judo
Megan_Fox	/award/award_nominee/award_nominations./award/award_nomination/nominated_for	Transformers
Chicago_White_Sox	/sports/professional_sports_team/draft_picks./sports/sports_league_draft_pick/school	Central_Michigan_University
J._R._R._Tolkien	/award/award_nominee/award_nominations./award/award_nomination/award	Prometheus_Award
Paul_Gross	/people/person/nationality	Canada
Doc_Watson	/people/person/profession	singer-songwriter
Tyrese_Gibson	/base/popstra/celebrity/friendship./base/popstra/friendship/participant	Larenz_Tate
Crash	/film/film/film_festivals	2010_Toronto_International_Film_Festival
Paul_Auster	/influence/influence_node/influenced_by	Franz_Kafka
Theodore_Shapiro	/people/person/places_lived./people/place_lived/location	Washington,_D.C.
Paramount_Pictures	/award/award_nominee/award_nominations./award/award_nomination/award	Tony_Award_for_Best_Revival_of_a_Musical
Paramount_Pictures	/film/film_distributor/films_distributed./film/film_film_distributor_relationship/film	Norbit
Shakira	/award/award_nominee/award_nominations./award/award_nomination/award	Latin_Grammy_Award_for_Song_of_the_Year
Uganda	/location/location/adjoin_s./location/adjoining_relationship/adjoins	Rwanda
James_Poyser	/music/artist/track_contributions./music/track_contribution/role	electric_piano
president	/business/job_title/people_with_this_title./business/employment_tenure/company	The_McClatchy_Company
2006_NCAA_Men's_Division_I_Basketball_Tournament	/base/marchmadness/ncaa_basketball_tournament/seeds./base/marchmadness/ncaa_tournament_seed/team	Illinois_Fighting_Illini_men's_basketball
Peter_Falk	/people/person/places_lived./people/place_lived/location	New_York_City
Miguel_Sandoval	/people/person/place_of_birth	Washington,_D.C.
Academy_Award_for_Best_Picture	/award/award_category/winners./award/award_honor/award_winner	Billy_Wilder
Dan_Castellaneta	/film/actor/film./film/performance/film	Recess:_School's_Out
Patrick_Gallagher	/award/award_winner/awards_won./award/award_honor/award_winner	Amber_Riley
Academy_Award_for_Best_Picture	/award/award_category/nominees./award/award_nomination/nominated_for	Butch_Cassidy_and_the_Sundance_Kid
Elite_Squad:_The_Enemy_Within	/film/film/film_format	35_mm_film
MASH	/film/film/production_companies	20th_Century_Fox
judo	/olympics/olympic_sport/athletes./olympics/olympic_athlete_affiliation/country	Guinea
Chiwetel_Ejiofor	/award/award_nominee/award_nominations./award/award_nomination/award_nominee	Denzel_Washington
Paramount_Pictures	/film/film_distributor/films_distributed./film/film_film_distributor_relationship/film	Ferris_Bueller's_Day_Off
The_Golden_Compass	/film/film/release_date_s./film/film_regional_release_date/film_release_region	Canada
post-punk	/music/genre/artists	Oingo_Boingo
broccoli	/food/food/nutrients./food/nutrition_fact/nutrient	Monounsaturated_fat
Toni_Braxton	/award/award_nominee/award_nominations./award/award_nomination/award	Grammy_Award_for_Best_Female_Pop_Vocal_Performance
Mushroom_Records	/music/record_label/artist	Dannii_Minogue
The_Ghost_and_the_Darkness	/film/film/cinematography	Vilmos_Zsigmond
Pan's_Labyrinth	/award/award_winning_work/awards_won./award/award_honor/award	National_Society_of_Film_Critics_Award_for_Best_Film
89th_United_States_Congress	/government/legislative_session/members./government/government_position_held/legislative_sessions	102nd_United_States_Congress
Parlophone	/music/record_label/artist	Brian_May
Shirley_Henderson	/film/actor/film./film/performance/film	Trainspotting
African_Americans	/people/ethnicity/people	Richard_Roundtree
double_bass	/music/instrument/instrumentalists	Ron_Carter
Delroy_Facey	/sports/pro_athlete/teams./sports/sports_team_roster/team	Tranmere_Rovers_F.C.
Sony_BMG	/music/record_label/artist	Bow_Wow
African_Americans	/people/ethnicity/people	Joshua_Redman
Filmfare_Award_for_Best_Supporting_Actor	/award/award_category/winners./award/award_honor/award_winner	Feroz_Khan
Philip_Glass	/people/person/places_lived./people/place_lived/location	New_York_City
Days_of_our_Lives	/award/award_winning_work/awards_won./award/award_honor/award	Daytime_Emmy_Award_for_Outstanding_Lead_Actor_in_a_Drama_Series
Academy_Award_for_Best_Picture	/award/award_category/nominees./award/award_nomination/nominated_for	The_French_Connection
University_of_Turin	/education/educational_institution/school_type	public_university
Steven_Bochco	/award/award_nominee/award_nominations./award/award_nomination/award	BAFTA_Academy_Fellowship_Award
57th_Golden_Globe_Awards	/award/award_ceremony/awards_presented./award/award_honor/award_winner	Denzel_Washington
The_Newton_Boys	/film/film/produced_by	Chris_Columbus
Buffalo_Bills	/sports/sports_team/roster./american_football/football_historical_roster_position/position_s	running_back
Jewish_people	/people/ethnicity/people	Al_Franken
Josh_Sussman	/award/award_nominee/award_nominations./award/award_nomination/award_nominee	Amber_Riley
Alison_Krauss	/music/artist/contribution./music/recording_contribution/performance_role	string_instrument
Paul_Walker	/film/actor/film./film/performance/film	The_Fast_and_the_Furious
twelve-string_guitar	/music/instrument/instrumentalists	Mike_Mogis
prime_minister	/government/government_office_category/officeholders./government/government_position_held/jurisdiction_of_office	Tunisia
Battle_Royale	/film/film/release_date_s./film/film_regional_release_date/film_release_region	Canada
Latin_Grammy_Awards_of_2004	/award/award_ceremony/awards_presented./award/award_honor/award_winner	Carlos_Santana
mayor	/government/government_office_category/officeholders./government/government_position_held/jurisdiction_of_office	Dallas
Real_Zaragoza	/sports/sports_team/colors	white
BAFTA_Award_for_Best_Actor_in_a_Supporting_Role	/award/award_category/nominees./award/award_nomination/nominated_for	The_Last_King_of_Scotland
20th_Century_Fox	/film/film_distributor/films_distributed./film/film_film_distributor_relationship/film	Speed
David_Lean	/award/award_nominee/award_nominations./award/award_nomination/award	BAFTA_Academy_Fellowship_Award
Heaven_Can_Wait	/film/film/production_companies	Paramount_Pictures
Steve_Schirripa	/award/award_nominee/award_nominations./award/award_nomination/award_nominee	Dan_Grimaldi
Ghostbusters_II	/film/film/featured_film_locations	New_York_City
20th_Century_Fox	/film/film_distributor/films_distributed./film/film_film_distributor_relationship/film	The_Crucible
Naruto_Shippuden_the_Movie:_Bonds	/film/film/genre	action_film
52nd_Annual_Grammy_Awards	/award/award_ceremony/awards_presented./award/award_honor/award_winner	Joshua_Redman
Patrizia_von_Brandenstein	/award/award_nominee/award_nominations./award/award_nomination/nominated_for	The_Untouchables
Russian_Civil_War	/military/military_conflict/combatants./military/military_combatant_group/combatants	Canada
Thoroughly_Modern_Millie	/award/award_winning_work/awards_won./award/award_honor/award_winner	Alfred_Newman
progressive_metal	/music/genre/artists	Steven_Wilson
African_Americans	/people/ethnicity/people	Denzel_Washington
Independent_Spirit_Award_for_Best_Director	/award/award_category/winners./award/award_honor/award_winner	Robert_Duvall
James_Mason	/film/actor/film./film/performance/film	Heaven_Can_Wait
National_Society_of_Film_Critics_Award_for_Best_Film	/award/award_category/nominees./award/award_nomination/nominated_for	Pan's_Labyrinth
20th_Century_Fox	/award/award_nominee/award_nominations./award/award_nomination/award_nominee	Ernst_Lubitsch
Colgate_University	/education/educational_institution/colors	white
Robert_De_Niro	/film/actor/film./film/performance/film	The_Deer_Hunter
Kirsten_Dunst	/award/award_nominee/award_nominations./award/award_nomination/award_nominee	Tobey_Maguire
Brandeis_University	/education/educational_institution/colors	white
Academy_Award_for_Best_Picture	/award/award_category/winners./award/award_honor/ceremony	43rd_Academy_Awards
Norfolk	/location/location/contains	King's_Lynn_and_West_Norfolk
Michigan_State_Spartans_football	/sports/sports_team/roster./american_football/football_historical_roster_position/position_s	running_back
Sam_Waterston	/people/person/place_of_birth	Cambridge
Ali	/film/film/music	Lisa_Gerrard
John_Huston	/award/award_nominee/award_nominations./award/award_nomination/award	Independent_Spirit_Award_for_Best_Director
Chris_Cooper	/award/award_nominee/award_nominations./award/award_nomination/award_nominee	Annette_Bening
Mike_Mogis	/music/artist/track_contributions./music/track_contribution/role	vibraphone
Allen_Covert	/award/award_nominee/award_nominations./award/award_nomination/award_nominee	Adam_Sandler
Death_on_the_Nile	/film/film/language	French
Doubt	/film/film/cinematography	Roger_Deakins
Sienna_Guillory	/award/award_nominee/award_nominations./award/award_nomination/award_nominee	Chiwetel_Ejiofor
Alaska	/location/location/contains	Bethel_Census_Area
Chris_Botti	/award/award_nominee/award_nominations./award/award_nomination/award_nominee	Alison_Krauss
broccoli	/food/food/nutrients./food/nutrition_fact/nutrient	L-Histidine
The_Gathering_Storm	/film/film/genre	biography
diploma	/education/educational_degree/people_with_this_degree./education/education/institution	Sciences_Po
Denzel_Washington	/film/actor/film./film/performance/film	The_Book_of_Eli
Teri_Polo	/people/person/places_lived./people/place_lived/location	New_York_City
The_Deer_Hunter	/award/award_winning_work/awards_won./award/award_honor/award	Academy_Award_for_Best_Picture
Columbia_College_Chicago	/education/educational_institution/colors	white
Chris_Tucker	/award/award_nominee/award_nominations./award/award_nomination/award_nominee	Robert_De_Niro
20th_Century_Fox	/film/film_distributor/films_distributed./film/film_film_distributor_relationship/film	Knight_and_Day
Grammy_Award_for_Best_Jazz_Instrumental_Album	/award/award_category/winners./award/award_honor/ceremony	1997_Grammy_Awards
Bow_Wow	/people/person/places_lived./people/place_lived/location	Columbus
The_Kite_Runner	/film/film/music	Alberto_Iglesias
Michael_Cera	/people/person/places_lived./people/place_lived/location	Brampton
Bowling_for_Columbine	/film/film/personal_appearances./film/personal_film_appearance/person	Michael_Moore
James_Stewart	/award/award_nominee/award_nominations./award/award_nomination/nominated_for	The_Philadelphia_Story
Chris_Thile	/award/award_winner/awards_won./award/award_honor/award_winner	Yo-Yo_Ma
Alison_Krauss	/people/person/profession	singer-songwriter
64th_Primetime_Creative_Arts_Emmy_Awards	/time/event/instance_of_recurring_event	Primetime_Emmy_Award
Kristin_Scott_Thomas	/award/award_nominee/award_nominations./award/award_nomination/nominated_for	Four_Weddings_and_a_Funeral
Matthew_Broderick	/film/actor/film./film/performance/film	You_Can_Count_on_Me
BAFTA_Award_for_Best_Actor_in_a_Supporting_Role	/award/award_category/nominees./award/award_nomination/nominated_for	Love_Actually
Tyrese_Gibson	/film/actor/film./film/performance/film	Transformers
Aruba	/base/aareas/schema/administrative_area/administrative_parent	Kingdom_of_the_Netherlands
Bob_Yari	/award/award_nominee/award_nominations./award/award_nomination/nominated_for	Crash
The_Fast_and_the_Furious	/film/film/genre	action_film
Lisa_Gerrard	/award/award_nominee/award_nominations./award/award_nomination/nominated_for	The_Insider
Paul_Mazursky	/award/award_nominee/award_nominations./award/award_nomination/award	Academy_Award_for_Best_Picture
Broward_County	/location/location/adjoin_s./location/adjoining_relationship/adjoins	Palm_Beach_County
Allen_Covert	/base/popstra/celebrity/friendship./base/popstra/friendship/participant	Adam_Sandler
Spanish	/education/field_of_study/students_majoring./education/education/major_field_of_study	French
Happy-Go-Lucky	/award/award_winning_work/awards_won./award/award_honor/award	National_Society_of_Film_Critics_Award_for_Best_Actress
Sony_BMG	/music/record_label/artist	Thin_Lizzy
The_Manchurian_Candidate	/film/film/cinematography	Tak_Fujimoto
Robert_De_Niro	/film/actor/film./film/performance/film	Jackie_Brown
Sony_BMG	/music/record_label/artist	Dido
Swedish_Empire	/location/country/capital	Stockholm
Teri_Garr	/people/person/profession	comedian
Jesus_Christ_Superstar	/film/film/release_date_s./film/film_regional_release_date/film_regional_debut_venue	New_York_City
Denzel_Washington	/film/actor/film./film/performance/film	Cry_Freedom
Sofia_Coppola	/film/director/film	Lost_in_Translation
Kirsten_Dunst	/film/actor/film./film/performance/film	Anastasia
Hereafter	/film/film/language	French
Paul_Giamatti	/award/award_nominee/award_nominations./award/award_nomination/nominated_for	Sideways
David_Healy	/soccer/football_player/current_team./sports/sports_team_roster/team	Doncaster_Rovers
52nd_Annual_Grammy_Awards	/award/award_ceremony/awards_presented./award/award_honor/award_winner	Lady_Gaga
Primetime_Emmy_Award_for_Outstanding_Main_Title_Theme_Music	/award/award_category/winners./award/award_honor/ceremony	59th_Primetime_Emmy_Awards
Christian_Bale	/film/actor/film./film/performance/film	The_Portrait_of_a_Lady
Neal_McDonough	/film/actor/film./film/performance/film	I_Know_Who_Killed_Me
Marisa_Tomei	/film/actor/film./film/performance/film	The_Newton_Boys
free_jazz	/music/genre/artists	Charles_Mingus_Jr.
Trey_Anastasio	/music/group_member/membership./music/group_membership/group	Phish
Madagascar	/film/film/language	French
EMI_Records	/music/record_label/artist	Marillion
Matthew_Broderick	/film/actor/film./film/performance/film	Godzilla
Paramount_Pictures	/film/film_distributor/films_distributed./film/film_film_distributor_relationship/film	The_Ghost_and_the_Darkness
Saul_Bellow	/influence/influence_node/influenced_by	Franz_Kafka
Helena_Bonham_Carter	/award/award_nominee/award_nominations./award/award_nomination/award	National_Society_of_Film_Critics_Award_for_Best_Actress
reggae	/music/genre/artists	Debbie_Harry
Final_Destination_5	/film/film/country	Canada
Gary_Rydstrom	/award/award_nominee/award_nominations./award/award_nomination/award	Academy_Award_for_Best_Animated_Short_Film
Andy_Warhol	/influence/influence_node/influenced_by	Marcel_Duchamp
Patricia_Heaton	/people/person/profession	comedian
Switzerland	/olympics/olympic_participating_country/medals_won./olympics/olympic_medal_honor/olympics	1976_Summer_Olympics
Ian_Bannen	/award/award_nominee/award_nominations./award/award_nomination/award	BAFTA_Award_for_Best_Actor_in_a_Supporting_Role
BAFTA_Award_for_Best_Animated_Film	/award/award_category/nominees./award/award_nomination/nominated_for	Up
Ticino	/base/aareas/schema/administrative_area/administrative_parent	Switzerland
Jenna_Ushkowitz	/award/award_winner/awards_won./award/award_honor/award_winner	Patrick_Gallagher
Paul_Giamatti	/film/actor/film./film/performance/film	The_Last_Station
Mike_Figgis	/award/award_nominee/award_nominations./award/award_nomination/award	Independent_Spirit_Award_for_Best_Director
Edward_R._Pressman	/award/award_winner/awards_won./award/award_honor/award_winner	Patricia_Heaton
left_fielder	/sports/sports_position/players./sports/sports_team_roster/team	Washington_Nationals
John_Hurt	/film/actor/film./film/performance/film	The_Newton_Boys
Meg_Ryan	/film/actor/film./film/performance/film	City_of_Angels
biathlon	/olympics/olympic_sport/athletes./olympics/olympic_athlete_affiliation/country	Canada
Ninotchka	/film/film/produced_by	Ernst_Lubitsch
Megan_Fox	/film/actor/film./film/performance/film	Transformers
Dwight_Yoakam	/film/actor/film./film/performance/film	The_Newton_Boys
judo	/olympics/olympic_sport/athletes./olympics/olympic_athlete_affiliation/country	Rwanda
National_Front_for_the_Liberation_of_South_Vietnam	/military/military_combatant/military_conflicts./military/military_combatant_group/combatants	North_Korea
Priest	/film/film/genre	action_film
Ashton_Kutcher	/film/actor/film./film/performance/film	New_Year's_Eve
Yo-Yo_Ma	/award/award_nominee/award_nominations./award/award_nomination/award_nominee	Chris_Thile
California_Polytechnic_State_University	/education/educational_institution/school_type	public_university
African_Americans	/people/ethnicity/people	Gladys_Knight
In_the_Mood_for_Love	/film/film/release_date_s./film/film_regional_release_date/film_release_region	Finland
Loretta_Devine	/film/actor/film./film/performance/film	Crash
Mithun_Chakraborty	/award/award_nominee/award_nominations./award/award_nomination/award	Filmfare_Award_for_Best_Supporting_Actor
Lost_in_Translation	/film/film/produced_by	Sofia_Coppola
Olivia_de_Havilland	/film/actor/film./film/performance/film	The_Guns_of_Navarone
Al_Franken	/people/person/profession	comedian
Red_State	/film/film/release_date_s./film/film_regional_release_date/film_release_region	Finland
King_Arthur	/film/film/produced_by	Jerry_Bruckheimer
Jim_Cummings	/film/actor/film./film/performance/film	Anastasia
Lili_Taylor	/award/award_nominee/award_nominations./award/award_nomination/nominated_for	Six_Feet_Under
University_of_California,_Los_Angeles	/education/educational_institution/students_graduates./education/education/student	Dido
slapstick	/media_common/netflix_genre/titles	Jackass_Number_Two
Filmfare_Award_for_Best_Supporting_Actor	/award/award_category/nominees./award/award_nomination/nominated_for	3_Idiots
Baltimore_Ravens	/sports/sports_team/roster./american_football/football_historical_roster_position/position_s	running_back
prime_minister	/government/government_office_category/officeholders./government/government_position_held/jurisdiction_of_office	Finland
Signs	/film/film/release_date_s./film/film_regional_release_date/film_release_region	Canada
Kristin_Scott_Thomas	/award/award_nominee/award_nominations./award/award_nomination/award	Golden_Raspberry_Award_for_Worst_New_Star
Kingdom_of_the_Netherlands	/location/location/contains	Friesland
Dwight_Yoakam	/award/award_winner/awards_won./award/award_honor/award_winner	Alison_Krauss
Danny_Trejo	/film/actor/film./film/performance/film	The_Muppets
Jewish_people	/people/ethnicity/people	Max_Fleischer
mayor	/government/government_office_category/officeholders./government/government_position_held/jurisdiction_of_office	Rostov-on-Don
Naked_Lunch	/film/film/release_date_s./film/film_regional_release_date/film_release_region	Finland
Ninotchka	/film/film/written_by	Billy_Wilder
Kingdom_of_England	/military/military_combatant/military_conflicts./military/military_combatant_group/combatants	Crown_of_Aragon/_corona_d'arago
Rwanda	/location/country/form_of_government	parliamentary_system
The_Wizard_of_Oz	/film/film/story_by	L._Frank_Baum
Training_Day	/award/award_winning_work/awards_won./award/award_honor/award_winner	Denzel_Washington
Carlos_Santana	/people/person/languages	Spanish
Alison_Krauss	/award/award_nominee/award_nominations./award/award_nomination/award_nominee	Joshua_Redman
Trinity_University	/education/educational_institution/colors	white
Academy_Award_for_Best_Picture	/award/award_category/nominees./award/award_nomination/nominated_for	Gaslight
Monster	/film/film/genre	biography
Robert_Duvall	/base/popstra/celebrity/friendship./base/popstra/friendship/participant	Dustin_Hoffman
Lee_Grant	/people/person/places_lived./people/place_lived/location	New_York_City
William_Petersen	/award/award_nominee/award_nominations./award/award_nomination/award_nominee	Jerry_Bruckheimer
Tony_Kushner	/award/award_nominee/award_nominations./award/award_nomination/award	Primetime_Emmy_Award_for_Outstanding_Writing_for_a_Miniseries,_Movie_or_a_Dramatic_Special
Berkshire	/location/location/contains	West_Berkshire
Love_Actually	/film/film/runtime./film/film_cut/film_release_region	Canada
Steven_Bochco	/people/person/place_of_birth	New_York_City
Josh_Sussman	/award/award_winner/awards_won./award/award_honor/award_winner	Amber_Riley
Josh_Sussman	/award/award_nominee/award_nominations./award/award_nomination/award_nominee	Jenna_Ushkowitz
Lou_Reed	/people/person/places_lived./people/place_lived/location	New_York_City
Salmon_Fishing_in_the_Yemen	/film/film/release_date_s./film/film_regional_release_date/film_release_region	Finland
Paramount_Pictures	/film/film_distributor/films_distributed./film/film_film_distributor_relationship/film	The_Untouchables
Love_Actually	/film/film/music	Craig_Armstrong
Geoffrey_Unsworth	/award/award_nominee/award_nominations./award/award_nomination/nominated_for	Cabaret
Academy_Award_for_Best_Picture	/award/award_category/nominees./award/award_nomination/nominated_for	Spellbound
Larenz_Tate	/base/popstra/celebrity/friendship./base/popstra/friendship/participant	Tyrese_Gibson
Jesus_Christ_Superstar	/film/film/release_date_s./film/film_regional_release_date/film_release_region	Finland
New_Year's_Eve	/film/film/release_date_s./film/film_regional_release_date/film_release_region	Malta
Roger_Daltrey	/people/person/profession	singer-songwriter
Rahul_Dev_Burman	/people/person/profession	music_director
Steve_Schirripa	/award/award_nominee/award_nominations./award/award_nomination/award_nominee	Jamie-Lynn_Sigler
post-bop	/music/genre/artists	Ron_Carter
Seven_Psychopaths	/film/film/release_date_s./film/film_regional_release_date/film_release_region	Finland
Edward_Kitsis	/award/award_nominee/award_nominations./award/award_nomination/award_nominee	J._J._Abrams
Akira_Kamiya	/film/actor/film./film/performance/film	Fist_of_the_North_Star
Matthew_Broderick	/base/popstra/celebrity/dated./base/popstra/dated/participant	Lili_Taylor
pneumonia	/people/cause_of_death/people	Freddie_Mercury
president	/government/government_office_category/officeholders./government/government_position_held/jurisdiction_of_office	Rwanda
Don_Henley	/award/award_nominee/award_nominations./award/award_nomination/award	MTV_Video_Music_Award_for_Best_Cinematography
National_Society_of_Film_Critics_Award_for_Best_Actress	/award/award_category/nominees./award/award_nomination/nominated_for	21_Grams
21st_Academy_Awards	/award/award_ceremony/awards_presented./award/award_honor/award_winner	Fred_Quimby
Frances_Conroy	/award/award_winner/awards_won./award/award_honor/award_winner	Lili_Taylor
president	/business/job_title/people_with_this_title./business/employment_tenure/company	Boeing
prime_minister	/government/government_office_category/officeholders./government/government_position_held/jurisdiction_of_office	Malta
Chandra_Wilson	/award/award_nominee/award_nominations./award/award_nomination/award_nominee	Kate_Walsh
Primetime_Emmy_Award_for_Outstanding_Main_Title_Theme_Music	/award/award_category/winners./award/award_honor/ceremony	64th_Primetime_Creative_Arts_Emmy_Awards
The_Philadelphia_Story	/film/film/language	French
trumpet	/music/performance_role/regular_performances./music/group_membership/group	Oingo_Boingo
City,_University_of_London	/education/educational_institution/colors	white
The_Kite_Runner	/film/film/featured_film_locations	Berkeley
J._J._Abrams	/people/person/places_lived./people/place_lived/location	New_York_City
road_cycling	/olympics/olympic_sport/athletes./olympics/olympic_athlete_affiliation/country	Finland
hanging	/people/cause_of_death/people	Saddam_Hussein
viola	/music/performance_role/track_performances./music/track_contribution/role	vibraphone
Rachel_Weisz	/people/person/spouse_s./people/marriage/location_of_ceremony	New_York_City
president	/government/government_office_category/officeholders./government/government_position_held/jurisdiction_of_office	Tunisia
University_of_Arkansas	/education/educational_institution/school_type	public_university
Chiwetel_Ejiofor	/film/actor/film./film/performance/film	Love_Actually
Grown_Ups	/film/film/executive_produced_by	Allen_Covert
Jenna_Ushkowitz	/award/award_nominee/award_nominations./award/award_nomination/award_nominee	Amber_Riley
mayor	/government/government_office_category/officeholders./government/government_position_held/jurisdiction_of_office	Norwalk
double_bass	/music/instrument/instrumentalists	Adrian_Belew
Dido	/award/award_nominee/award_nominations./award/award_nomination/award	MTV_Video_Music_Award_for_Best_Cinematography
The_Insider	/film/film/featured_film_locations	Berkeley
King_Arthur	/film/film/production_companies	Touchstone_Pictures
Finland	/olympics/olympic_participating_country/medals_won./olympics/olympic_medal_honor/olympics	1964_Summer_Olympics
The_Golden_Compass	/film/film/other_crew./film/film_crew_gig/film_crew_role	animation_director
Kathleen_Kennedy	/award/award_winner/awards_won./award/award_honor/award_winner	Peter_Jackson
Gironde	/base/aareas/schema/administrative_area/capital	Bordeaux
Canada	/location/location/contains	Brandon
Chris_Botti	/music/artist/track_contributions./music/track_contribution/role	trumpet
Scandinavia	/location/location/contains	Finland
Sofia_Coppola	/award/award_nominee/award_nominations./award/award_nomination/award	Independent_Spirit_Award_for_Best_Director
47th_Academy_Awards	/award/award_ceremony/awards_presented./award/award_honor/award_winner	Federico_Fellini
20th_Century_Fox	/film/film_distributor/films_distributed./film/film_film_distributor_relationship/film	Chicken_Run
contemporary_R&B	/music/genre/artists	The_Isley_Brothers
Unstoppable	/film/film/production_companies	20th_Century_Fox
Seattle_SuperSonics	/sports/professional_sports_team/draft_picks./sports/sports_league_draft_pick/school	University_of_Kansas
Life_Insurance_Corporation_of_India	/base/schemastaging/organization_extra/phone_number./base/schemastaging/phone_sandbox/service_location	Goa
Primetime_Emmy_Award_for_Outstanding_Main_Title_Design	/award/award_category/category_of	Primetime_Emmy_Award
Ethan_Hawke	/people/person/places_lived./people/place_lived/location	New_York_City
Chris_Thile	/people/person/place_of_birth	Oceanside
James_L._Brooks	/award/award_nominee/award_nominations./award/award_nomination/award_nominee	Matt_Selman
Polish_American	/people/ethnicity/people	Peter_Falk
Malayali	/people/ethnicity/languages_spoken	Malayalam
president	/government/government_office_category/officeholders./government/government_position_held/jurisdiction_of_office	Fiji
Anthony_Mackie	/award/award_winner/awards_won./award/award_honor/award_winner	Guy_Pearce
The_Last_Station	/film/film/film_production_design_by	Patrizia_von_Brandenstein
Battle_Royale	/film/film/genre	action_film
running_back	/sports/sports_position/players./sports/sports_team_roster/team	Oregon_State_Beavers_football
The_Manchurian_Candidate	/film/film/production_companies	Paramount_Pictures
Gretchen_Mol	/award/award_nominee/award_nominations./award/award_nomination/nominated_for	Boardwalk_Empire
Benin	/location/location/adjoin_s./location/adjoining_relationship/adjoins	Niger
106th_United_States_Congress	/government/legislative_session/members./government/government_position_held/legislative_sessions	89th_United_States_Congress
pneumonia	/people/cause_of_death/people	Irving_Thalberg
Memento	/award/award_winning_work/awards_won./award/award_honor/award	Independent_Spirit_Award_for_Best_Director
Quadrophenia	/film/film/release_date_s./film/film_regional_release_date/film_release_region	Canada
The_Insider	/film/film/featured_film_locations	New_York_City
Nebula_Award_for_Best_Novel	/award/award_category/winners./award/award_honor/award_winner	David_Brin
Fred_Willard	/people/person/profession	comedian
Speed	/film/film/music	Mark_Mancina
Sofia_Coppola	/people/person/places_lived./people/place_lived/location	New_York_City
The_Untouchables	/film/film/featured_film_locations	Chicago
Sony_BMG	/music/record_label/artist	Jamiroquai
Blue_Velvet	/award/award_winning_work/awards_won./award/award_honor/award	National_Society_of_Film_Critics_Award_for_Best_Film
Academy_Award_for_Best_Picture	/award/award_category/winners./award/award_honor/award_winner	20th_Century_Fox
Billy_Wilder	/award/award_nominee/award_nominations./award/award_nomination/award	Academy_Award_for_Best_Picture
Niger	/location/location/adjoin_s./location/adjoining_relationship/adjoins	Benin
viola	/music/performance_role/regular_performances./music/group_membership/role	electric_piano
Tsinghua_University	/education/educational_institution/colors	white
Benicio_del_Toro	/award/award_nominee/award_nominations./award/award_nomination/nominated_for	21_Grams
Larenz_Tate	/award/award_nominee/award_nominations./award/award_nomination/nominated_for	Crash
20th_Century_Fox	/award/award_nominee/award_nominations./award/award_nomination/nominated_for	Anastasia
Takahiro_Sakurai	/film/actor/film./film/performance/film	Final_Fantasy_VII:_Advent_Children
Invictus	/film/film/genre	biography
Paul_Reubens	/award/award_nominee/award_nominations./award/award_nomination/award_nominee	Shirley_Henderson
The_Philadelphia_Story	/award/award_winning_work/awards_won./award/award_honor/award_winner	James_Stewart
20th_Century_Fox	/film/film_distributor/films_distributed./film/film_film_distributor_relationship/film	X2
Lars_Hirschfeld	/soccer/football_player/current_team./sports/sports_team_roster/team	Tottenham_Hotspur_F.C.
The_Artist	/award/award_winning_work/awards_won./award/award_honor/award	Independent_Spirit_Award_for_Best_Director
Sony_Pictures_Home_Entertainment	/film/film_distributor/films_distributed./film/film_film_distributor_relationship/film	Final_Fantasy_VII:_Advent_Children
Anthony_Mackie	/film/actor/film./film/performance/film	8_Mile
Henry_King	/award/award_nominee/award_nominations./award/award_nomination/nominated_for	Love_Is_a_Many-Splendored_Thing
Switzerland	/location/country/official_language	French
contemporary_R&B	/music/genre/artists	Shakira
Paranormal_Activity	/film/film/release_date_s./film/film_regional_release_date/film_release_region	Canada
president	/business/job_title/people_with_this_title./business/employment_tenure/company	FC_Bayern_Munich
Crash	/film/film/language	Spanish
Salmon_Fishing_in_the_Yemen	/film/film/release_date_s./film/film_regional_release_date/film_release_region	Canada
Aruba	/location/administrative_division/country	Kingdom_of_the_Netherlands
Life_Insurance_Corporation_of_India	/base/schemastaging/organization_extra/phone_number./base/schemastaging/phone_sandbox/service_location	Mysore
Richard_Nixon	/government/politician/government_positions_held./government/government_position_held/basic_title	vice_president
James_Pickens	/award/award_nominee/award_nominations./award/award_nomination/award_nominee	Chandra_Wilson
Julianna_Margulies	/award/award_nominee/award_nominations./award/award_nomination/award	Screen_Actors_Guild_Award_for_Outstanding_Performance_by_a_Female_Actor_in_a_Drama_Series
Maryland_Terrapins_football	/sports/sports_team/colors	white
Tom_Kenny	/people/person/place_of_birth	Syracuse
Santa_Monica_College	/education/educational_institution/colors	white
president	/government/government_office_category/officeholders./government/government_position_held/jurisdiction_of_office	Socialist_Federal_Republic_of_Yugoslavia
Lost_in_Translation	/film/film/genre	comedy_of_manners
James_Monroe	/government/politician/government_positions_held./government/government_position_held/basic_title	president
Kingdom_of_the_Netherlands	/location/location/contains	Alkmaar
Olympique_Lyonnais	/sports/sports_team/colors	white
Fairfield_County	/location/location/contains	Norwalk
salsa	/music/genre/artists	Carlos_Santana
Irish_migration_to_Great_Britain	/people/ethnicity/people	Gerard_Butler
Paul_Francis_Webster	/music/artist/origin	New_York_City
Academy_Award_for_Best_Picture	/award/award_category/nominees./award/award_nomination/nominated_for	Top_Hat
Eli_Wallach	/film/actor/film./film/performance/film	The_Ghost_Writer
Vassar_College	/education/educational_institution/school_type	mixed-sex_education
Sony_BMG	/music/record_label/artist	Journey
Deva	/people/person/profession	music_director
Dragon_Ball_Z:_Lord_Slug	/film/film/genre	action_film
Loyola_University_Chicago	/education/educational_institution/school_type	private_university
Lafayette_College	/education/educational_institution/colors	white
Jewish_people	/people/ethnicity/people	Barbara_Walters
brass_instrument	/music/performance_role/regular_performances./music/group_membership/group	Simply_Red
North_Carolina_Agricultural_and_Technical_State_University	/education/educational_institution/school_type	university
Get_Carter	/film/film/produced_by	Elie_Samaha
The_Wizard_of_Oz	/film/film/music	Harold_Arlen
Lloyd_Alexander	/influence/influence_node/influenced_by	J._R._R._Tolkien
Freddie_Prinze	/people/person/languages	Spanish
Switzerland	/location/location/contains	Rhine
head_teacher	/business/job_title/people_with_this_title./business/employment_tenure/company	Rugby_School
Bordeaux	/location/capital_of_administrative_division/capital_of./location/administrative_division_capital_relationship/administrative_division	Gironde
heartland_rock	/music/genre/artists	Steve_Earle
defenceman	/sports/sports_position/players./sports/sports_team_roster/team	Pittsburgh_Penguins
Lori_Alan	/people/person/profession	comedian
Janeane_Garofalo	/award/award_nominee/award_nominations./award/award_nomination/award_nominee	Teri_Polo
Bates_College	/education/educational_institution/school_type	private_university
Madrid	/base/popstra/location/vacationers./base/popstra/vacation_choice/vacationer	Ethan_Hawke
Canal+	/base/schemastaging/organization_extra/phone_number./base/schemastaging/phone_sandbox/service_language	French
David_Hilbert	/people/person/profession	mathematician
Andy_Serkis	/film/actor/film./film/performance/film	The_Lord_of_the_Rings:_The_Fellowship_of_the_Ring
Stephen_Hawking	/people/person/profession	mathematician
Jewish_people	/people/ethnicity/people	Richard_Feynman
Aphex_Twin	/people/person/place_of_birth	Limerick
Sega_Games	/base/schemastaging/organization_extra/phone_number./base/schemastaging/phone_sandbox/service_language	Spanish
Yu-Gi-Oh!_GX	/tv/tv_program/regular_cast./tv/regular_tv_appearance/actor	Kappei_Yamaguchi
San_Francisco_Art_Institute	/education/educational_institution/colors	grey
Billy_Corgan	/people/person/profession	singer-songwriter
rap_metal	/music/genre/artists	Travis_Barker
African_Americans	/people/ethnicity/people	Octavia_Spencer
Bill_Bruford	/people/person/profession	drummer
University_College	/education/educational_institution/students_graduates./education/education/student	Stephen_Hawking
post-punk	/music/genre/artists	David_J
heartland_rock	/music/genre/artists	Los_Lobos
Christopher_Cross	/people/person/profession	singer-songwriter
Rollins_College	/education/educational_institution/school_type	private_university
Latin_Grammy_Awards_of_2005	/award/award_ceremony/awards_presented./award/award_honor/award_winner	Daddy_Yankee
Little_Children	/film/film/music	Thomas_Newman
South_Dakota	/location/statistical_region/religions./location/religion_percentage/religion	Seventh-day_Adventist_Church
New_Zealand_national_cricket_team	/sports/sports_team/colors	white
Robert_Lantos	/people/person/nationality	Canada
University_of_Otago	/education/educational_institution/school_type	public_university
defenceman	/sports/sports_position/players./sports/sports_team_roster/team	St._Louis_Blues
MSNBC	/organization/organization/headquarters./location/mailing_address/citytown	New_York_City
Utah_Utes_football	/sports/sports_team/colors	white
Bob_Newhart	/people/person/profession	comedian
106th_United_States_Congress	/government/legislative_session/members./government/government_position_held/district_represented	Louisiana
Lesotho	/location/country/form_of_government	parliamentary_system
H._G._Wells	/people/deceased_person/place_of_burial	Golders_Green_Crematorium
Canada	/location/location/contains	Vancouver_Island
Kingdom_of_the_Netherlands	/location/location/contains	Utrecht
Twin_Peaks	/tv/tv_program/genre	cult_film
Guildhall_School_of_Music_and_Drama	/education/educational_institution/students_graduates./education/education/student	Lesley_Sharp
James_Hong	/film/actor/film./film/performance/film	Love_Is_a_Many-Splendored_Thing
Jewish_people	/people/ethnicity/people	Ashley_Tisdale
